PM_VETTEL_FLAVOR	ヴェテルの記憶の断片が刻まれた、思念<br>の結晶。この結晶を所持する者とヴェテ<br>ルの想いが共鳴した際、錬金術による幻<br>影兵の行使に近しい力を一時借り受ける<br>ことができる。
PM_GERALD_FLAVOR	ジェラルドの記憶の断片が刻まれた、思<br>念の結晶。この結晶を所持する者とジェ<br>ラルドの想いが共鳴した際、錬金術によ<br>る幻影兵の行使に近しい力を一時借り受<br>けることができる。
PM_NATALIE_FLAVOR	ナタリーの記憶の断片が刻まれた、思念<br>の結晶。この結晶を所持する者とナタリ<br>ーの想いが共鳴した際、錬金術による幻<br>影兵の行使に近しい力を一時借り受ける<br>ことができる。
PM_CLOE_FLAVOR	クロエの記憶の断片が刻まれた、思念の<br>結晶。この結晶を所持する者とクロエの<br>想いが共鳴した際、錬金術による幻影兵<br>の行使に近しい力を一時借り受けること<br>ができる。
PM_VICTOR_FLAVOR	ヴィクターの記憶の断片が刻まれた、思<br>念の結晶。この結晶を所持する者とヴィ<br>クターの想いが共鳴した際、錬金術によ<br>る幻影兵の行使に近しい力を一時借り受<br>けることができる。
PM_REN_FLAVOR	レンの記憶の断片が刻まれた、思念の結<br>晶。この結晶を所持する者とレンの想い<br>が共鳴した際、錬金術による幻影兵の行<br>使に近しい力を一時借り受けることがで<br>きる。
PM_NINA_FLAVOR	ニーナの記憶の断片が刻まれた、思念の<br>結晶。この結晶を所持する者とニーナの<br>想いが共鳴した際、錬金術による幻影兵<br>の行使に近しい力を一時借り受けること<br>ができる。
PM_DARTAGNAN_FLAVOR	ダルタニアンの記憶の断片が刻まれた、<br>思念の結晶。この結晶を所持する者とダ<br>ルタニアンの想いが共鳴した際、錬金術<br>による幻影兵の行使に近しい力を一時借<br>り受けることができる。
PM_BUD_FLAVOR	バドの記憶の断片が刻まれた、思念の結<br>晶。この結晶を所持する者とバドの想い<br>が共鳴した際、錬金術による幻影兵の行<br>使に近しい力を一時借り受けることがで<br>きる。
PM_LOGI_FLAVOR	ロギの記憶の断片が刻まれた、思念の結<br>晶。この結晶を所持する者とロギの想い<br>が共鳴した際、錬金術による幻影兵の行<br>使に近しい力を一時借り受けることがで<br>きる。
PM_DIOS_FLAVOR	ディオスの記憶の断片が刻まれた、思念<br>の結晶。この結晶を所持する者とディオ<br>スの想いが共鳴した際、錬金術による幻<br>影兵の行使に近しい力を一時借り受ける<br>ことができる。
PM_ZEKE_FLAVOR	ジークの記憶の断片が刻まれた、思念の<br>結晶。この結晶を所持する者とジークの<br>想いが共鳴した際、錬金術による幻影兵<br>の行使に近しい力を一時借り受けること<br>ができる。
PM_LUCRETIA_FLAVOR	ルクレティアの記憶の断片が刻まれた、<br>思念の結晶。この結晶を所持する者とル<br>クレティアの想いが共鳴した際、錬金術<br>による幻影兵の行使に近しい力を一時借<br>り受けることができる。
PM_DILGA_FLAVOR	ディルガの記憶の断片が刻まれた、思念<br>の結晶。この結晶を所持する者とディル<br>ガの想いが共鳴した際、錬金術による幻<br>影兵の行使に近しい力を一時借り受ける<br>ことができる。
PM_PRISCILA_FLAVOR	プリシラの記憶の断片が刻まれた、思念<br>の結晶。この結晶を所持する者とプリシ<br>ラの想いが共鳴した際、錬金術による幻<br>影兵の行使に近しい力を一時借り受ける<br>ことができる。
PM_GINO_FLAVOR	ジーノの記憶の断片が刻まれた、思念の<br>結晶。この結晶を所持する者とジーノの<br>想いが共鳴した際、錬金術による幻影兵<br>の行使に近しい力を一時借り受けること<br>ができる。
PM_LEONIA_FLAVOR	レオニアの記憶の断片が刻まれた、思念<br>の結晶。この結晶を所持する者とレオニ<br>アの想いが共鳴した際、錬金術による幻<br>影兵の行使に近しい力を一時借り受ける<br>ことができる。
PM_FRAISE_FLAVOR	フレイズの記憶の断片が刻まれた、思念<br>の結晶。この結晶を所持する者とフレイ<br>ズの想いが共鳴した際、錬金術による幻<br>影兵の行使に近しい力を一時借り受ける<br>ことができる。
PM_YURA_FLAVOR	ユラの記憶の断片が刻まれた、思念の結<br>晶。この結晶を所持する者とユラの想い<br>が共鳴した際、錬金術による幻影兵の行<br>使に近しい力を一時借り受けることがで<br>きる。
PM_KALMIA_FLAVOR	カルミアの記憶の断片が刻まれた、思念<br>の結晶。この結晶を所持する者とカルミ<br>アの想いが共鳴した際、錬金術による幻<br>影兵の行使に近しい力を一時借り受ける<br>ことができる。
PM_GAYN_FLAVOR	ゲインの記憶の断片が刻まれた、思念の<br>結晶。この結晶を所持する者とゲインの<br>想いが共鳴した際、錬金術による幻影兵<br>の行使に近しい力を一時借り受けること<br>ができる。
PM_ZAYIN_FLAVOR	ザインの記憶の断片が刻まれた、思念の<br>結晶。この結晶を所持する者とザインの<br>想いが共鳴した際、錬金術による幻影兵<br>の行使に近しい力を一時借り受けること<br>ができる。
PM_CANON_FLAVOR	カノンの記憶の断片が刻まれた、思念の<br>結晶。この結晶を所持する者とカノンの<br>想いが共鳴した際、錬金術による幻影兵<br>の行使に近しい力を一時借り受けること<br>ができる。
PM_CADANOVA_FLAVOR	カダノバの記憶の断片が刻まれた、思念<br>の結晶。この結晶を所持する者とカダノ<br>バの想いが共鳴した際、錬金術による幻<br>影兵の行使に近しい力を一時借り受ける<br>ことができる。
PM_KAGURA_FLAVOR	カグラの記憶の断片が刻まれた、思念の<br>結晶。この結晶を所持する者とカグラの<br>想いが共鳴した際、錬金術による幻影兵<br>の行使に近しい力を一時借り受けること<br>ができる。
PM_KUDHANSTEIN_FLAVOR	クダンシュタインの記憶の断片が刻まれ<br>た、思念の結晶。この結晶を所持する者<br>とクダンシュタインの想いが共鳴した際<br>、錬金術による幻影兵の行使に近しい力<br>を一時借り受けることができる。
PM_MONZEIN_FLAVOR	モンゼインの記憶の断片が刻まれた、思<br>念の結晶。この結晶を所持する者とモン<br>ゼインの想いが共鳴した際、錬金術によ<br>る幻影兵の行使に近しい力を一時借り受<br>けることができる。
PM_SEIDA_FLAVOR	セーダの記憶の断片が刻まれた、思念の<br>結晶。この結晶を所持する者とセーダの<br>想いが共鳴した際、錬金術による幻影兵<br>の行使に近しい力を一時借り受けること<br>ができる。
PM_YAULAS_FLAVOR	ヤウラスの記憶の断片が刻まれた、思念<br>の結晶。この結晶を所持する者とヤウラ<br>スの想いが共鳴した際、錬金術による幻<br>影兵の行使に近しい力を一時借り受ける<br>ことができる。
PM_OTHIMA_FLAVOR	オーティマの記憶の断片が刻まれた、思<br>念の結晶。この結晶を所持する者とオー<br>ティマの想いが共鳴した際、錬金術によ<br>る幻影兵の行使に近しい力を一時借り受<br>けることができる。
PM_BASINI_FLAVOR	バシーニの記憶の断片が刻まれた、思念<br>の結晶。この結晶を所持する者とバシー<br>ニの想いが共鳴した際、錬金術による幻<br>影兵の行使に近しい力を一時借り受ける<br>ことができる。
PM_RAKINA_FLAVOR	ラキナの記憶の断片が刻まれた、思念の<br>結晶。この結晶を所持する者とラキナの<br>想いが共鳴した際、錬金術による幻影兵<br>の行使に近しい力を一時借り受けること<br>ができる。
PM_KAYA_FLAVOR	カヤの記憶の断片が刻まれた、思念の結<br>晶。この結晶を所持する者とカヤの想い<br>が共鳴した際、錬金術による幻影兵の行<br>使に近しい力を一時借り受けることがで<br>きる。
PM_IKASA_FLAVOR	イカサの記憶の断片が刻まれた、思念の<br>結晶。この結晶を所持する者とイカサの<br>想いが共鳴した際、錬金術による幻影兵<br>の行使に近しい力を一時借り受けること<br>ができる。
PM_GLANZ_FLAVOR	グランツの記憶の断片が刻まれた、思念<br>の結晶。この結晶を所持する者とグラン<br>ツの想いが共鳴した際、錬金術による幻<br>影兵の行使に近しい力を一時借り受ける<br>ことができる。
PM_LAMIA_FLAVOR	ラミアの記憶の断片が刻まれた、思念の<br>結晶。この結晶を所持する者とラミアの<br>想いが共鳴した際、錬金術による幻影兵<br>の行使に近しい力を一時借り受けること<br>ができる。
PM_TERESA_FLAVOR	テレサの記憶の断片が刻まれた、思念の<br>結晶。この結晶を所持する者とテレサの<br>想いが共鳴した際、錬金術による幻影兵<br>の行使に近しい力を一時借り受けること<br>ができる。
PM_ANASTASIA_FLAVOR	アナスタシアの記憶の断片が刻まれた、<br>思念の結晶。この結晶を所持する者とア<br>ナスタシアの想いが共鳴した際、錬金術<br>による幻影兵の行使に近しい力を一時借<br>り受けることができる。
PM_ISHUNA_FLAVOR	イシュナの記憶の断片が刻まれた、思念<br>の結晶。この結晶を所持する者とイシュ<br>ナの想いが共鳴した際、錬金術による幻<br>影兵の行使に近しい力を一時借り受ける<br>ことができる。
PM_RACHEL_FLAVOR	ラシェルの記憶の断片が刻まれた、思念<br>の結晶。この結晶を所持する者とラシェ<br>ルの想いが共鳴した際、錬金術による幻<br>影兵の行使に近しい力を一時借り受ける<br>ことができる。
PM_NEVILLE_FLAVOR	ネヴィルの記憶の断片が刻まれた、思念<br>の結晶。この結晶を所持する者とネヴィ<br>ルの想いが共鳴した際、錬金術による幻<br>影兵の行使に近しい力を一時借り受ける<br>ことができる。
PM_CAESAR_FLAVOR	カイザルの記憶の断片が刻まれた、思念<br>の結晶。この結晶を所持する者とカイザ<br>ルの想いが共鳴した際、錬金術による幻<br>影兵の行使に近しい力を一時借り受ける<br>ことができる。
PM_VLAD_FLAVOR	ブラドの記憶の断片が刻まれた、思念の<br>結晶。この結晶を所持する者とブラドの<br>想いが共鳴した際、錬金術による幻影兵<br>の行使に近しい力を一時借り受けること<br>ができる。
PM_ZAHAR_FLAVOR	ザハルの記憶の断片が刻まれた、思念の<br>結晶。この結晶を所持する者とザハルの<br>想いが共鳴した際、錬金術による幻影兵<br>の行使に近しい力を一時借り受けること<br>ができる。
PM_SPICA_FLAVOR	スピカの記憶の断片が刻まれた、思念の<br>結晶。この結晶を所持する者とスピカの<br>想いが共鳴した際、錬金術による幻影兵<br>の行使に近しい力を一時借り受けること<br>ができる。
PM_MARE_FLAVOR	メアの記憶の断片が刻まれた、思念の結<br>晶。この結晶を所持する者とメアの想い<br>が共鳴した際、錬金術による幻影兵の行<br>使に近しい力を一時借り受けることがで<br>きる。
PM_ZENN_FLAVOR	ゼンの記憶の断片が刻まれた、思念の結<br>晶。この結晶を所持する者とゼンの想い<br>が共鳴した際、錬金術による幻影兵の行<br>使に近しい力を一時借り受けることがで<br>きる。
PM_NIGURU_FLAVOR	ニグルの記憶の断片が刻まれた、思念の<br>結晶。この結晶を所持する者とニグルの<br>想いが共鳴した際、錬金術による幻影兵<br>の行使に近しい力を一時借り受けること<br>ができる。
PM_IRA_FLAVOR	イーラの記憶の断片が刻まれた、思念の<br>結晶。この結晶を所持する者とイーラの<br>想いが共鳴した際、錬金術による幻影兵<br>の行使に近しい力を一時借り受けること<br>ができる。
PM_SHIRMA_FLAVOR	シルマの記憶の断片が刻まれた、思念の<br>結晶。この結晶を所持する者とシルマの<br>想いが共鳴した際、錬金術による幻影兵<br>の行使に近しい力を一時借り受けること<br>ができる。
PM_LETICIA_FLAVOR	レティシアの記憶の断片が刻まれた、思<br>念の結晶。この結晶を所持する者とレテ<br>ィシアの想いが共鳴した際、錬金術によ<br>る幻影兵の行使に近しい力を一時借り受<br>けることができる。
PM_ACHAD_FLAVOR	アハトの記憶の断片が刻まれた、思念の<br>結晶。この結晶を所持する者とアハトの<br>想いが共鳴した際、錬金術による幻影兵<br>の行使に近しい力を一時借り受けること<br>ができる。
PM_VIER_FLAVOR	フィーアの記憶の断片が刻まれた、思念<br>の結晶。この結晶を所持する者とフィー<br>アの想いが共鳴した際、錬金術による幻<br>影兵の行使に近しい力を一時借り受ける<br>ことができる。
PM_THOL_FLAVOR	ソルの記憶の断片が刻まれた、思念の結<br>晶。この結晶を所持する者とソルの想い<br>が共鳴した際、錬金術による幻影兵の行<br>使に近しい力を一時借り受けることがで<br>きる。
PM_ZWEI_FLAVOR	ツヴァイの記憶の断片が刻まれた、思念<br>の結晶。この結晶を所持する者とツヴァ<br>イの想いが共鳴した際、錬金術による幻<br>影兵の行使に近しい力を一時借り受ける<br>ことができる。
PM_NOIN_FLAVOR	ノインの記憶の断片が刻まれた、思念の<br>結晶。この結晶を所持する者とノインの<br>想いが共鳴した際、錬金術による幻影兵<br>の行使に近しい力を一時借り受けること<br>ができる。
PM_ZYVA_FLAVOR	ズィーヴァの記憶の断片が刻まれた、思<br>念の結晶。この結晶を所持する者とズィ<br>ーヴァの想いが共鳴した際、錬金術によ<br>る幻影兵の行使に近しい力を一時借り受<br>けることができる。
PM_DREI_FLAVOR	ドライの記憶の断片が刻まれた、思念の<br>結晶。この結晶を所持する者とドライの<br>想いが共鳴した際、錬金術による幻影兵<br>の行使に近しい力を一時借り受けること<br>ができる。
PM_FURY_FLAVOR	フューリーの記憶の断片が刻まれた、思<br>念の結晶。この結晶を所持する者とフュ<br>ーリーの想いが共鳴した際、錬金術によ<br>る幻影兵の行使に近しい力を一時借り受<br>けることができる。
PM_EINZ_FLAVOR	アインツの記憶の断片が刻まれた、思念<br>の結晶。この結晶を所持する者とアイン<br>ツの想いが共鳴した際、錬金術による幻<br>影兵の行使に近しい力を一時借り受ける<br>ことができる。
PM_ZEX_FLAVOR	ゼクスの記憶の断片が刻まれた、思念の<br>結晶。この結晶を所持する者とゼクスの<br>想いが共鳴した際、錬金術による幻影兵<br>の行使に近しい力を一時借り受けること<br>ができる。
PM_NERO_FLAVOR	ネロの記憶の断片が刻まれた、思念の結<br>晶。この結晶を所持する者とネロの想い<br>が共鳴した際、錬金術による幻影兵の行<br>使に近しい力を一時借り受けることがで<br>きる。
PM_SETSUNA_FLAVOR	セツナの記憶の断片が刻まれた、思念の<br>結晶。この結晶を所持する者とセツナの<br>想いが共鳴した際、錬金術による幻影兵<br>の行使に近しい力を一時借り受けること<br>ができる。
PM_ZIN_FLAVOR	ジンの記憶の断片が刻まれた、思念の結<br>晶。この結晶を所持する者とジンの想い<br>が共鳴した際、錬金術による幻影兵の行<br>使に近しい力を一時借り受けることがで<br>きる。
PM_YOMI_FLAVOR	ヨミの記憶の断片が刻まれた、思念の結<br>晶。この結晶を所持する者とヨミの想い<br>が共鳴した際、錬金術による幻影兵の行<br>使に近しい力を一時借り受けることがで<br>きる。
PM_KURT_FLAVOR	クレトの記憶の断片が刻まれた、思念の<br>結晶。この結晶を所持する者とクレトの<br>想いが共鳴した際、錬金術による幻影兵<br>の行使に近しい力を一時借り受けること<br>ができる。
PM_SUZUKA_FLAVOR	スズカの記憶の断片が刻まれた、思念の<br>結晶。この結晶を所持する者とスズカの<br>想いが共鳴した際、錬金術による幻影兵<br>の行使に近しい力を一時借り受けること<br>ができる。
PM_REIMEI_FLAVOR	レイメイの記憶の断片が刻まれた、思念<br>の結晶。この結晶を所持する者とレイメ<br>イの想いが共鳴した際、錬金術による幻<br>影兵の行使に近しい力を一時借り受ける<br>ことができる。
PM_NATSUME_FLAVOR	ナツメの記憶の断片が刻まれた、思念の<br>結晶。この結晶を所持する者とナツメの<br>想いが共鳴した際、錬金術による幻影兵<br>の行使に近しい力を一時借り受けること<br>ができる。
PM_KUZA_FLAVOR	クウザの記憶の断片が刻まれた、思念の<br>結晶。この結晶を所持する者とクウザの<br>想いが共鳴した際、錬金術による幻影兵<br>の行使に近しい力を一時借り受けること<br>ができる。
PM_BALT_FLAVOR	バルトの記憶の断片が刻まれた、思念の<br>結晶。この結晶を所持する者とバルトの<br>想いが共鳴した際、錬金術による幻影兵<br>の行使に近しい力を一時借り受けること<br>ができる。
PM_RAMESES_FLAVOR	ラメセスの記憶の断片が刻まれた、思念<br>の結晶。この結晶を所持する者とラメセ<br>スの想いが共鳴した際、錬金術による幻<br>影兵の行使に近しい力を一時借り受ける<br>ことができる。
PM_ANKH_FLAVOR	アンクの記憶の断片が刻まれた、思念の<br>結晶。この結晶を所持する者とアンクの<br>想いが共鳴した際、錬金術による幻影兵<br>の行使に近しい力を一時借り受けること<br>ができる。
PM_RYLE_FLAVOR	ライルの記憶の断片が刻まれた、思念の<br>結晶。この結晶を所持する者とライルの<br>想いが共鳴した際、錬金術による幻影兵<br>の行使に近しい力を一時借り受けること<br>ができる。
PM_ASUWADO_FLAVOR	アスワドの記憶の断片が刻まれた、思念<br>の結晶。この結晶を所持する者とアスワ<br>ドの想いが共鳴した際、錬金術による幻<br>影兵の行使に近しい力を一時借り受ける<br>ことができる。
PM_UZUMA_FLAVOR	ウズマの記憶の断片が刻まれた、思念の<br>結晶。この結晶を所持する者とウズマの<br>想いが共鳴した際、錬金術による幻影兵<br>の行使に近しい力を一時借り受けること<br>ができる。
PM_NEFERTY_FLAVOR	ネフェルティの記憶の断片が刻まれた、<br>思念の結晶。この結晶を所持する者とネ<br>フェルティの想いが共鳴した際、錬金術<br>による幻影兵の行使に近しい力を一時借<br>り受けることができる。
PM_CARLA_FLAVOR	カルラの記憶の断片が刻まれた、思念の<br>結晶。この結晶を所持する者とカルラの<br>想いが共鳴した際、錬金術による幻影兵<br>の行使に近しい力を一時借り受けること<br>ができる。
PM_SHENMEI_FLAVOR	シェンメイの記憶の断片が刻まれた、思<br>念の結晶。この結晶を所持する者とシェ<br>ンメイの想いが共鳴した際、錬金術によ<br>る幻影兵の行使に近しい力を一時借り受<br>けることができる。
PM_RISHEN_FLAVOR	リューシェンの記憶の断片が刻まれた、<br>思念の結晶。この結晶を所持する者とリ<br>ューシェンの想いが共鳴した際、錬金術<br>による幻影兵の行使に近しい力を一時借<br>り受けることができる。
PM_SIYI_FLAVOR	スーイーの記憶の断片が刻まれた、思念<br>の結晶。この結晶を所持する者とスーイ<br>ーの想いが共鳴した際、錬金術による幻<br>影兵の行使に近しい力を一時借り受ける<br>ことができる。
PM_GORMALAS_FLAVOR	ゴルマラスの記憶の断片が刻まれた、思<br>念の結晶。この結晶を所持する者とゴル<br>マラスの想いが共鳴した際、錬金術によ<br>る幻影兵の行使に近しい力を一時借り受<br>けることができる。
PM_SHAYNA_FLAVOR	シェイナの記憶の断片が刻まれた、思念<br>の結晶。この結晶を所持する者とシェイ<br>ナの想いが共鳴した際、錬金術による幻<br>影兵の行使に近しい力を一時借り受ける<br>ことができる。
PM_RAURA_FLAVOR	ラウラの記憶の断片が刻まれた、思念の<br>結晶。この結晶を所持する者とラウラの<br>想いが共鳴した際、錬金術による幻影兵<br>の行使に近しい力を一時借り受けること<br>ができる。
PM_ORION_FLAVOR	オライオンの記憶の断片が刻まれた、思<br>念の結晶。この結晶を所持する者とオラ<br>イオンの想いが共鳴した際、錬金術によ<br>る幻影兵の行使に近しい力を一時借り受<br>けることができる。
PM_LEAFA_FLAVOR	リーファの記憶の断片が刻まれた、思念<br>の結晶。この結晶を所持する者とリーフ<br>ァの想いが共鳴した際、錬金術による幻<br>影兵の行使に近しい力を一時借り受ける<br>ことができる。
PM_LANGHAO_FLAVOR	ランハオの記憶の断片が刻まれた、思念<br>の結晶。この結晶を所持する者とランハ<br>オの想いが共鳴した際、錬金術による幻<br>影兵の行使に近しい力を一時借り受ける<br>ことができる。
PM_NAJU_FLAVOR	ナァヂュの記憶の断片が刻まれた、思念<br>の結晶。この結晶を所持する者とナァヂ<br>ュの想いが共鳴した際、錬金術による幻<br>影兵の行使に近しい力を一時借り受ける<br>ことができる。
PM_MAGNUS_FLAVOR	マグヌスの記憶の断片が刻まれた、思念<br>の結晶。この結晶を所持する者とマグヌ<br>スの想いが共鳴した際、錬金術による幻<br>影兵の行使に近しい力を一時借り受ける<br>ことができる。
PM_RYUI_FLAVOR	リュイの記憶の断片が刻まれた、思念の<br>結晶。この結晶を所持する者とリュイの<br>想いが共鳴した際、錬金術による幻影兵<br>の行使に近しい力を一時借り受けること<br>ができる。
PM_WILHELM_FLAVOR	ヴィルヘルムの記憶の断片が刻まれた、<br>思念の結晶。この結晶を所持する者とヴ<br>ィルヘルムの想いが共鳴した際、錬金術<br>による幻影兵の行使に近しい力を一時借<br>り受けることができる。
PM_ALBELL_FLAVOR	アルベルの記憶の断片が刻まれた、思念<br>の結晶。この結晶を所持する者とアルベ<br>ルの想いが共鳴した際、錬金術による幻<br>影兵の行使に近しい力を一時借り受ける<br>ことができる。
PM_HAZEL_FLAVOR	ヘイゼルの記憶の断片が刻まれた、思念<br>の結晶。この結晶を所持する者とヘイゼ<br>ルの想いが共鳴した際、錬金術による幻<br>影兵の行使に近しい力を一時借り受ける<br>ことができる。
PM_EVERICA_FLAVOR	エヴェリカの記憶の断片が刻まれた、思<br>念の結晶。この結晶を所持する者とエヴ<br>ェリカの想いが共鳴した際、錬金術によ<br>る幻影兵の行使に近しい力を一時借り受<br>けることができる。
PM_KURAJU_FLAVOR	クラージュの記憶の断片が刻まれた、思<br>念の結晶。この結晶を所持する者とクラ<br>ージュの想いが共鳴した際、錬金術によ<br>る幻影兵の行使に近しい力を一時借り受<br>けることができる。
PM_LIESBET_FLAVOR	リズベットの記憶の断片が刻まれた、思<br>念の結晶。この結晶を所持する者とリズ<br>ベットの想いが共鳴した際、錬金術によ<br>る幻影兵の行使に近しい力を一時借り受<br>けることができる。
PM_MORE_FLAVOR	モアの記憶の断片が刻まれた、思念の結<br>晶。この結晶を所持する者とモアの想い<br>が共鳴した際、錬金術による幻影兵の行<br>使に近しい力を一時借り受けることがで<br>きる。
PM_REBECCA_FLAVOR	レベッカの記憶の断片が刻まれた、思念<br>の結晶。この結晶を所持する者とレベッ<br>カの想いが共鳴した際、錬金術による幻<br>影兵の行使に近しい力を一時借り受ける<br>ことができる。
PM_ALMA_FLAVOR	アルマの記憶の断片が刻まれた、思念の<br>結晶。この結晶を所持する者とアルマの<br>想いが共鳴した際、錬金術による幻影兵<br>の行使に近しい力を一時借り受けること<br>ができる。
PM_EVE_FLAVOR	イヴの記憶の断片が刻まれた、思念の結<br>晶。この結晶を所持する者とイヴの想い<br>が共鳴した際、錬金術による幻影兵の行<br>使に近しい力を一時借り受けることがで<br>きる。
PM_LEYCHEL_FLAVOR	レイチェルの記憶の断片が刻まれた、思<br>念の結晶。この結晶を所持する者とレイ<br>チェルの想いが共鳴した際、錬金術によ<br>る幻影兵の行使に近しい力を一時借り受<br>けることができる。
PM_CELES_FLAVOR	セリスの記憶の断片が刻まれた、思念の<br>結晶。この結晶を所持する者とセリスの<br>想いが共鳴した際、錬金術による幻影兵<br>の行使に近しい力を一時借り受けること<br>ができる。
PM_TANOSUKE_FLAVOR	タノスケの記憶の断片が刻まれた、思念<br>の結晶。この結晶を所持する者とタノス<br>ケの想いが共鳴した際、錬金術による幻<br>影兵の行使に近しい力を一時借り受ける<br>ことができる。
PM_UGACHI_FLAVOR	ウガチの記憶の断片が刻まれた、思念の<br>結晶。この結晶を所持する者とウガチの<br>想いが共鳴した際、錬金術による幻影兵<br>の行使に近しい力を一時借り受けること<br>ができる。
PM_AMANE_FLAVOR	アマネの記憶の断片が刻まれた、思念の<br>結晶。この結晶を所持する者とアマネの<br>想いが共鳴した際、錬金術による幻影兵<br>の行使に近しい力を一時借り受けること<br>ができる。
PM_JUBEI_FLAVOR	ジュウベエの記憶の断片が刻まれた、思<br>念の結晶。この結晶を所持する者とジュ<br>ウベエの想いが共鳴した際、錬金術によ<br>る幻影兵の行使に近しい力を一時借り受<br>けることができる。
PM_HOO_FLAVOR	フゥの記憶の断片が刻まれた、思念の結<br>晶。この結晶を所持する者とフゥの想い<br>が共鳴した際、錬金術による幻影兵の行<br>使に近しい力を一時借り受けることがで<br>きる。
PM_VODA_FLAVOR	ヴォダの記憶の断片が刻まれた、思念の<br>結晶。この結晶を所持する者とヴォダの<br>想いが共鳴した際、錬金術による幻影兵<br>の行使に近しい力を一時借り受けること<br>ができる。
PM_TEHRE_FLAVOR	テーレの記憶の断片が刻まれた、思念の<br>結晶。この結晶を所持する者とテーレの<br>想いが共鳴した際、錬金術による幻影兵<br>の行使に近しい力を一時借り受けること<br>ができる。
PM_TINA_FLAVOR	ティナの記憶の断片が刻まれた、思念の<br>結晶。この結晶を所持する者とティナの<br>想いが共鳴した際、錬金術による幻影兵<br>の行使に近しい力を一時借り受けること<br>ができる。
PM_MOCA_FLAVOR	モカの記憶の断片が刻まれた、思念の結<br>晶。この結晶を所持する者とモカの想い<br>が共鳴した際、錬金術による幻影兵の行<br>使に近しい力を一時借り受けることがで<br>きる。
PM_TAMISU_FLAVOR	タミスの記憶の断片が刻まれた、思念の<br>結晶。この結晶を所持する者とタミスの<br>想いが共鳴した際、錬金術による幻影兵<br>の行使に近しい力を一時借り受けること<br>ができる。
PM_AINANNA_FLAVOR	アイナンナの記憶の断片が刻まれた、思<br>念の結晶。この結晶を所持する者とアイ<br>ナンナの想いが共鳴した際、錬金術によ<br>る幻影兵の行使に近しい力を一時借り受<br>けることができる。
PM_BIANCA_FLAVOR	ビアンカの記憶の断片が刻まれた、思念<br>の結晶。この結晶を所持する者とビアン<br>カの想いが共鳴した際、錬金術による幻<br>影兵の行使に近しい力を一時借り受ける<br>ことができる。
PM_TORITOH_FLAVOR	トリトーの記憶の断片が刻まれた、思念<br>の結晶。この結晶を所持する者とトリト<br>ーの想いが共鳴した際、錬金術による幻<br>影兵の行使に近しい力を一時借り受ける<br>ことができる。
PM_ROSA_FLAVOR	ローザの記憶の断片が刻まれた、思念の<br>結晶。この結晶を所持する者とローザの<br>想いが共鳴した際、錬金術による幻影兵<br>の行使に近しい力を一時借り受けること<br>ができる。
PM_LOTIA_FLAVOR	ローティアの記憶の断片が刻まれた、思<br>念の結晶。この結晶を所持する者とロー<br>ティアの想いが共鳴した際、錬金術によ<br>る幻影兵の行使に近しい力を一時借り受<br>けることができる。
PM_IZAYOI_FLAVOR	イザヨイの記憶の断片が刻まれた、思念<br>の結晶。この結晶を所持する者とイザヨ<br>イの想いが共鳴した際、錬金術による幻<br>影兵の行使に近しい力を一時借り受ける<br>ことができる。
PM_EDGAR_FLAVOR	エドガーの記憶の断片が刻まれた、思念<br>の結晶。この結晶を所持する者とエドガ<br>ーの想いが共鳴した際、錬金術による幻<br>影兵の行使に近しい力を一時借り受ける<br>ことができる。
PM_SYARON_FLAVOR	シャロンの記憶の断片が刻まれた、思念<br>の結晶。この結晶を所持する者とシャロ<br>ンの想いが共鳴した際、錬金術による幻<br>影兵の行使に近しい力を一時借り受ける<br>ことができる。
PM_TEONA_FLAVOR	テオナの記憶の断片が刻まれた、思念の<br>結晶。この結晶を所持する者とテオナの<br>想いが共鳴した際、錬金術による幻影兵<br>の行使に近しい力を一時借り受けること<br>ができる。
PM_BELTA_FLAVOR	ベルタの記憶の断片が刻まれた、思念の<br>結晶。この結晶を所持する者とベルタの<br>想いが共鳴した際、錬金術による幻影兵<br>の行使に近しい力を一時借り受けること<br>ができる。
PM_TAMAMO_FLAVOR	タマモの記憶の断片が刻まれた、思念の<br>結晶。この結晶を所持する者とタマモの<br>想いが共鳴した際、錬金術による幻影兵<br>の行使に近しい力を一時借り受けること<br>ができる。
PM_CHERYL_FLAVOR	シェリルの記憶の断片が刻まれた、思念<br>の結晶。この結晶を所持する者とシェリ<br>ルの想いが共鳴した際、錬金術による幻<br>影兵の行使に近しい力を一時借り受ける<br>ことができる。
PM_ROFIA_FLAVOR	ロフィアの記憶の断片が刻まれた、思念<br>の結晶。この結晶を所持する者とロフィ<br>アの想いが共鳴した際、錬金術による幻<br>影兵の行使に近しい力を一時借り受ける<br>ことができる。
PM_LAVINA_FLAVOR	ラヴィーナの記憶の断片が刻まれた、思<br>念の結晶。この結晶を所持する者とラヴ<br>ィーナの想いが共鳴した際、錬金術によ<br>る幻影兵の行使に近しい力を一時借り受<br>けることができる。
PM_MICHAEL_FLAVOR	ミハエルの記憶の断片が刻まれた、思念<br>の結晶。この結晶を所持する者とミハエ<br>ルの想いが共鳴した際、錬金術による幻<br>影兵の行使に近しい力を一時借り受ける<br>ことができる。
PM_ELIZABETH_FLAVOR	エリザベスの記憶の断片が刻まれた、思<br>念の結晶。この結晶を所持する者とエリ<br>ザベスの想いが共鳴した際、錬金術によ<br>る幻影兵の行使に近しい力を一時借り受<br>けることができる。
PM_MIUNA_FLAVOR	ミウナの記憶の断片が刻まれた、思念の<br>結晶。この結晶を所持する者とミウナの<br>想いが共鳴した際、錬金術による幻影兵<br>の行使に近しい力を一時借り受けること<br>ができる。
PM_ZANGETSU_FLAVOR	ザンゲツの記憶の断片が刻まれた、思念<br>の結晶。この結晶を所持する者とザンゲ<br>ツの想いが共鳴した際、錬金術による幻<br>影兵の行使に近しい力を一時借り受ける<br>ことができる。
PM_KAMUI_FLAVOR	カムイの記憶の断片が刻まれた、思念の<br>結晶。この結晶を所持する者とカムイの<br>想いが共鳴した際、錬金術による幻影兵<br>の行使に近しい力を一時借り受けること<br>ができる。
PM_SABALETA_FLAVOR	サバレタの記憶の断片が刻まれた、思念<br>の結晶。この結晶を所持する者とサバレ<br>タの想いが共鳴した際、錬金術による幻<br>影兵の行使に近しい力を一時借り受ける<br>ことができる。
PM_KEVIN_FLAVOR	ケヴィンの記憶の断片が刻まれた、思念<br>の結晶。この結晶を所持する者とケヴィ<br>ンの想いが共鳴した際、錬金術による幻<br>影兵の行使に近しい力を一時借り受ける<br>ことができる。
PM_FUNGLIU_FLAVOR	フォン・リウの記憶の断片が刻まれた、<br>思念の結晶。この結晶を所持する者とフ<br>ォン・リウの想いが共鳴した際、錬金術<br>による幻影兵の行使に近しい力を一時借<br>り受けることができる。
PM_CHIHAYA_FLAVOR	チハヤの記憶の断片が刻まれた、思念の<br>結晶。この結晶を所持する者とチハヤの<br>想いが共鳴した際、錬金術による幻影兵<br>の行使に近しい力を一時借り受けること<br>ができる。
PM_POLLIN_FLAVOR	ポリンの記憶の断片が刻まれた、思念の<br>結晶。この結晶を所持する者とポリンの<br>想いが共鳴した際、錬金術による幻影兵<br>の行使に近しい力を一時借り受けること<br>ができる。
PM_MASHULI_FLAVOR	マシュリの記憶の断片が刻まれた、思念<br>の結晶。この結晶を所持する者とマシュ<br>リの想いが共鳴した際、錬金術による幻<br>影兵の行使に近しい力を一時借り受ける<br>ことができる。
PM_GUILDFORD_FLAVOR	ギルフォードの記憶の断片が刻まれた、<br>思念の結晶。この結晶を所持する者とギ<br>ルフォードの想いが共鳴した際、錬金術<br>による幻影兵の行使に近しい力を一時借<br>り受けることができる。
PM_DECEL_FLAVOR	デセルの記憶の断片が刻まれた、思念の<br>結晶。この結晶を所持する者とデセルの<br>想いが共鳴した際、錬金術による幻影兵<br>の行使に近しい力を一時借り受けること<br>ができる。
PM_UROBOROS_LEGACY_FLAVOR	ウロボロス・レガシーの記憶の断片が刻<br>まれた、思念の結晶。この結晶を所持す<br>る者とウロボロス・レガシーの想いが共<br>鳴した際、錬金術による幻影兵の行使に<br>近しい力を一時借り受けることができる<br>。
PM_DAPHNE_FLAVOR	ダフネの記憶の断片が刻まれた、思念の<br>結晶。この結晶を所持する者とダフネの<br>想いが共鳴した際、錬金術による幻影兵<br>の行使に近しい力を一時借り受けること<br>ができる。
PM_MESARTHIM_FLAVOR	メサルティムの記憶の断片が刻まれた、<br>思念の結晶。この結晶を所持する者とメ<br>サルティムの想いが共鳴した際、錬金術<br>による幻影兵の行使に近しい力を一時借<br>り受けることができる。
PM_NICAEA_FLAVOR	ニカイアの記憶の断片が刻まれた、思念<br>の結晶。この結晶を所持する者とニカイ<br>アの想いが共鳴した際、錬金術による幻<br>影兵の行使に近しい力を一時借り受ける<br>ことができる。
PM_ADOREI_FLAVOR	アドレイの記憶の断片が刻まれた、思念<br>の結晶。この結晶を所持する者とアドレ<br>イの想いが共鳴した際、錬金術による幻<br>影兵の行使に近しい力を一時借り受ける<br>ことができる。
PM_IKONA_FLAVOR	イコーナの記憶の断片が刻まれた、思念<br>の結晶。この結晶を所持する者とイコー<br>ナの想いが共鳴した際、錬金術による幻<br>影兵の行使に近しい力を一時借り受ける<br>ことができる。
PM_MINARIO_FLAVOR	ミナリオの記憶の断片が刻まれた、思念<br>の結晶。この結晶を所持する者とミナリ<br>オの想いが共鳴した際、錬金術による幻<br>影兵の行使に近しい力を一時借り受ける<br>ことができる。
PM_MELA_FLAVOR	メラの記憶の断片が刻まれた、思念の結<br>晶。この結晶を所持する者とメラの想い<br>が共鳴した際、錬金術による幻影兵の行<br>使に近しい力を一時借り受けることがで<br>きる。
PM_NIKUSU_FLAVOR	ニクスの記憶の断片が刻まれた、思念の<br>結晶。この結晶を所持する者とニクスの<br>想いが共鳴した際、錬金術による幻影兵<br>の行使に近しい力を一時借り受けること<br>ができる。
PM_AMBROSIA_FLAVOR	アンブロシアの記憶の断片が刻まれた、<br>思念の結晶。この結晶を所持する者とア<br>ンブロシアの想いが共鳴した際、錬金術<br>による幻影兵の行使に近しい力を一時借<br>り受けることができる。
PM_QENS_FLAVOR	クェンスの記憶の断片が刻まれた、思念<br>の結晶。この結晶を所持する者とクェン<br>スの想いが共鳴した際、錬金術による幻<br>影兵の行使に近しい力を一時借り受ける<br>ことができる。
PM_CLABUL_FLAVOR	クレーブルの記憶の断片が刻まれた、思<br>念の結晶。この結晶を所持する者とクレ<br>ーブルの想いが共鳴した際、錬金術によ<br>る幻影兵の行使に近しい力を一時借り受<br>けることができる。
PM_NIMURU_FLAVOR	ニムルの記憶の断片が刻まれた、思念の<br>結晶。この結晶を所持する者とニムルの<br>想いが共鳴した際、錬金術による幻影兵<br>の行使に近しい力を一時借り受けること<br>ができる。
PM_EMMEL_FLAVOR	エンメルの記憶の断片が刻まれた、思念<br>の結晶。この結晶を所持する者とエンメ<br>ルの想いが共鳴した際、錬金術による幻<br>影兵の行使に近しい力を一時借り受ける<br>ことができる。
PM_JUURIA_FLAVOR	ジューリアの記憶の断片が刻まれた、思<br>念の結晶。この結晶を所持する者とジュ<br>ーリアの想いが共鳴した際、錬金術によ<br>る幻影兵の行使に近しい力を一時借り受<br>けることができる。
PM_EULALIA_FLAVOR	エウラリアの記憶の断片が刻まれた、思<br>念の結晶。この結晶を所持する者とエウ<br>ラリアの想いが共鳴した際、錬金術によ<br>る幻影兵の行使に近しい力を一時借り受<br>けることができる。
PM_MATHIAS_FLAVOR	マティアの記憶の断片が刻まれた、思念<br>の結晶。この結晶を所持する者とマティ<br>アの想いが共鳴した際、錬金術による幻<br>影兵の行使に近しい力を一時借り受ける<br>ことができる。
PM_ZAFIRITH_FLAVOR	ザフィリスの記憶の断片が刻まれた、思<br>念の結晶。この結晶を所持する者とザフ<br>ィリスの想いが共鳴した際、錬金術によ<br>る幻影兵の行使に近しい力を一時借り受<br>けることができる。
PM_WAGINAO_FLAVOR	ワギナオの記憶の断片が刻まれた、思念<br>の結晶。この結晶を所持する者とワギナ<br>オの想いが共鳴した際、錬金術による幻<br>影兵の行使に近しい力を一時借り受ける<br>ことができる。
PM_SURUBA_FLAVOR	スルバの記憶の断片が刻まれた、思念の<br>結晶。この結晶を所持する者とスルバの<br>想いが共鳴した際、錬金術による幻影兵<br>の行使に近しい力を一時借り受けること<br>ができる。
PM_ANDECHS_FLAVOR	アンデクスの記憶の断片が刻まれた、思<br>念の結晶。この結晶を所持する者とアン<br>デクスの想いが共鳴した際、錬金術によ<br>る幻影兵の行使に近しい力を一時借り受<br>けることができる。
PM_BENIKA_FLAVOR	ベニカの記憶の断片が刻まれた、思念の<br>結晶。この結晶を所持する者とベニカの<br>想いが共鳴した際、錬金術による幻影兵<br>の行使に近しい力を一時借り受けること<br>ができる。
PM_KUBERA_FLAVOR	クベラの記憶の断片が刻まれた、思念の<br>結晶。この結晶を所持する者とクベラの<br>想いが共鳴した際、錬金術による幻影兵<br>の行使に近しい力を一時借り受けること<br>ができる。
PM_KU_IENA_FLAVOR	ク・イエナの記憶の断片が刻まれた、思<br>念の結晶。この結晶を所持する者とク・<br>イエナの想いが共鳴した際、錬金術によ<br>る幻影兵の行使に近しい力を一時借り受<br>けることができる。
PM_IGNACIO_FLAVOR	イグナシオの記憶の断片が刻まれた、思<br>念の結晶。この結晶を所持する者とイグ<br>ナシオの想いが共鳴した際、錬金術によ<br>る幻影兵の行使に近しい力を一時借り受<br>けることができる。
PM_SHAHAR_FLAVOR	シャヘルの記憶の断片が刻まれた、思念<br>の結晶。この結晶を所持する者とシャヘ<br>ルの想いが共鳴した際、錬金術による幻<br>影兵の行使に近しい力を一時借り受ける<br>ことができる。
PM_HELENE_FLAVOR	ヘレネーの記憶の断片が刻まれた、思念<br>の結晶。この結晶を所持する者とヘレネ<br>ーの想いが共鳴した際、錬金術による幻<br>影兵の行使に近しい力を一時借り受ける<br>ことができる。
PM_ESAI_IGNACIO_FLAVOR	エサイ・イグナシオの記憶の断片が刻ま<br>れた、思念の結晶。この結晶を所持する<br>者とエサイ・イグナシオの想いが共鳴し<br>た際、錬金術による幻影兵の行使に近し<br>い力を一時借り受けることができる。
PM_ALMILA_FLAVOR	アルミラの記憶の断片が刻まれた、思念<br>の結晶。この結晶を所持する者とアルミ<br>ラの想いが共鳴した際、錬金術による幻<br>影兵の行使に近しい力を一時借り受ける<br>ことができる。
PM_RAHU_FLAVOR	ラーフの記憶の断片が刻まれた、思念の<br>結晶。この結晶を所持する者とラーフの<br>想いが共鳴した際、錬金術による幻影兵<br>の行使に近しい力を一時借り受けること<br>ができる。
PM_MARGARET_FLAVOR	マーガレットの記憶の断片が刻まれた、<br>思念の結晶。この結晶を所持する者とマ<br>ーガレットの想いが共鳴した際、錬金術<br>による幻影兵の行使に近しい力を一時借<br>り受けることができる。
PM_KYARORU_FLAVOR	キャロルの記憶の断片が刻まれた、思念<br>の結晶。この結晶を所持する者とキャロ<br>ルの想いが共鳴した際、錬金術による幻<br>影兵の行使に近しい力を一時借り受ける<br>ことができる。
PM_TANBA_FLAVOR	タンバの記憶の断片が刻まれた、思念の<br>結晶。この結晶を所持する者とタンバの<br>想いが共鳴した際、錬金術による幻影兵<br>の行使に近しい力を一時借り受けること<br>ができる。
PM_KAEDE_FLAVOR	カエデの記憶の断片が刻まれた、思念の<br>結晶。この結晶を所持する者とカエデの<br>想いが共鳴した際、錬金術による幻影兵<br>の行使に近しい力を一時借り受けること<br>ができる。
PM_SCHMEIER_FLAVOR	シュメイアの記憶の断片が刻まれた、思<br>念の結晶。この結晶を所持する者とシュ<br>メイアの想いが共鳴した際、錬金術によ<br>る幻影兵の行使に近しい力を一時借り受<br>けることができる。
PM_CARNET_FLAVOR	カルネの記憶の断片が刻まれた、思念の<br>結晶。この結晶を所持する者とカルネの<br>想いが共鳴した際、錬金術による幻影兵<br>の行使に近しい力を一時借り受けること<br>ができる。
PM_LYCORIS_FLAVOR	リコリスの記憶の断片が刻まれた、思念<br>の結晶。この結晶を所持する者とリコリ<br>スの想いが共鳴した際、錬金術による幻<br>影兵の行使に近しい力を一時借り受ける<br>ことができる。
PM_ANNEROSE_FLAVOR	アンネローズの記憶の断片が刻まれた、<br>思念の結晶。この結晶を所持する者とア<br>ンネローズの想いが共鳴した際、錬金術<br>による幻影兵の行使に近しい力を一時借<br>り受けることができる。
PM_KLIMA_FLAVOR	クリーマの記憶の断片が刻まれた、思念<br>の結晶。この結晶を所持する者とクリー<br>マの想いが共鳴した際、錬金術による幻<br>影兵の行使に近しい力を一時借り受ける<br>ことができる。
PM_BIRGITTA_FLAVOR	ビルギッタの記憶の断片が刻まれた、思<br>念の結晶。この結晶を所持する者とビル<br>ギッタの想いが共鳴した際、錬金術によ<br>る幻影兵の行使に近しい力を一時借り受<br>けることができる。
PM_MELVIREI_FLAVOR	メルビレイの記憶の断片が刻まれた、思<br>念の結晶。この結晶を所持する者とメル<br>ビレイの想いが共鳴した際、錬金術によ<br>る幻影兵の行使に近しい力を一時借り受<br>けることができる。
PM_IRENE_FLAVOR	イレーネの記憶の断片が刻まれた、思念<br>の結晶。この結晶を所持する者とイレー<br>ネの想いが共鳴した際、錬金術による幻<br>影兵の行使に近しい力を一時借り受ける<br>ことができる。
PM_THALIA_FLAVOR	サリアの記憶の断片が刻まれた、思念の<br>結晶。この結晶を所持する者とサリアの<br>想いが共鳴した際、錬金術による幻影兵<br>の行使に近しい力を一時借り受けること<br>ができる。
PM_ESTELA_FLAVOR	エステラの記憶の断片が刻まれた、思念<br>の結晶。この結晶を所持する者とエステ<br>ラの想いが共鳴した際、錬金術による幻<br>影兵の行使に近しい力を一時借り受ける<br>ことができる。
PM_AMIS_FLAVOR	アミスの記憶の断片が刻まれた、思念の<br>結晶。この結晶を所持する者とアミスの<br>想いが共鳴した際、錬金術による幻影兵<br>の行使に近しい力を一時借り受けること<br>ができる。
PM_VINCENT_FLAVOR	ヴィンセントの記憶の断片が刻まれた、<br>思念の結晶。この結晶を所持する者とヴ<br>ィンセントの想いが共鳴した際、錬金術<br>による幻影兵の行使に近しい力を一時借<br>り受けることができる。
PM_MEGISTOS_FLAVOR	メギストスの記憶の断片が刻まれた、思<br>念の結晶。この結晶を所持する者とメギ<br>ストスの想いが共鳴した際、錬金術によ<br>る幻影兵の行使に近しい力を一時借り受<br>けることができる。
PM_GINO_02_FLAVOR	ジーノの記憶の断片が刻まれた、思念の<br>結晶。この結晶を所持する者とジーノの<br>想いが共鳴した際、錬金術による幻影兵<br>の行使に近しい力を一時借り受けること<br>ができる。
PM_IRENE_02_FLAVOR	イレーネの記憶の断片が刻まれた、思念<br>の結晶。この結晶を所持する者とイレー<br>ネの想いが共鳴した際、錬金術による幻<br>影兵の行使に近しい力を一時借り受ける<br>ことができる。
PM_MITSUHA_FLAVOR	ミツハの記憶の断片が刻まれた、思念の<br>結晶。この結晶を所持する者とミツハの<br>想いが共鳴した際、錬金術による幻影兵<br>の行使に近しい力を一時借り受けること<br>ができる。
PM_VERMIO_FLAVOR	ヴェルミオの記憶の断片が刻まれた、思<br>念の結晶。この結晶を所持する者とヴェ<br>ルミオの想いが共鳴した際、錬金術によ<br>る幻影兵の行使に近しい力を一時借り受<br>けることができる。
PM_MABEL_FLAVOR	メイベルの記憶の断片が刻まれた、思念<br>の結晶。この結晶を所持する者とメイベ<br>ルの想いが共鳴した際、錬金術による幻<br>影兵の行使に近しい力を一時借り受ける<br>ことができる。
PM_VIVI_FLAVOR	ヴィヴィの記憶の断片が刻まれた、思念<br>の結晶。この結晶を所持する者とヴィヴ<br>ィの想いが共鳴した際、錬金術による幻<br>影兵の行使に近しい力を一時借り受ける<br>ことができる。
PM_HUGO_FLAVOR	ヒューゴの記憶の断片が刻まれた、思念<br>の結晶。この結晶を所持する者とヒュー<br>ゴの想いが共鳴した際、錬金術による幻<br>影兵の行使に近しい力を一時借り受ける<br>ことができる。
PM_MEIFAN_FLAVOR	メイファンの記憶の断片が刻まれた、思<br>念の結晶。この結晶を所持する者とメイ<br>ファンの想いが共鳴した際、錬金術によ<br>る幻影兵の行使に近しい力を一時借り受<br>けることができる。
PM_YUEN_FLAVOR	ユーエンの記憶の断片が刻まれた、思念<br>の結晶。この結晶を所持する者とユーエ<br>ンの想いが共鳴した際、錬金術による幻<br>影兵の行使に近しい力を一時借り受ける<br>ことができる。
PM_LUCILLE_FLAVOR	ルーシャの記憶の断片が刻まれた、思念<br>の結晶。この結晶を所持する者とルーシ<br>ャの想いが共鳴した際、錬金術による幻<br>影兵の行使に近しい力を一時借り受ける<br>ことができる。
PM_EMA_FLAVOR	エマの記憶の断片が刻まれた、思念の結<br>晶。この結晶を所持する者とエマの想い<br>が共鳴した際、錬金術による幻影兵の行<br>使に近しい力を一時借り受けることがで<br>きる。
PM_NOAH_FLAVOR	ノアの記憶の断片が刻まれた、思念の結<br>晶。この結晶を所持する者とノアの想い<br>が共鳴した際、錬金術による幻影兵の行<br>使に近しい力を一時借り受けることがで<br>きる。
PM_PAMERA_FLAVOR	パメラの記憶の断片が刻まれた、思念の<br>結晶。この結晶を所持する者とパメラの<br>想いが共鳴した際、錬金術による幻影兵<br>の行使に近しい力を一時借り受けること<br>ができる。
PM_PAMERA_02_FLAVOR	パメラの記憶の断片が刻まれた、思念の<br>結晶。この結晶を所持する者とパメラの<br>想いが共鳴した際、錬金術による幻影兵<br>の行使に近しい力を一時借り受けること<br>ができる。
PM_LINDRAKE_FLAVOR	リンドレイクの記憶の断片が刻まれた、<br>思念の結晶。この結晶を所持する者とリ<br>ンドレイクの想いが共鳴した際、錬金術<br>による幻影兵の行使に近しい力を一時借<br>り受けることができる。
PM_RIMA_FLAVOR	リーマの記憶の断片が刻まれた、思念の<br>結晶。この結晶を所持する者とリーマの<br>想いが共鳴した際、錬金術による幻影兵<br>の行使に近しい力を一時借り受けること<br>ができる。
PM_DAISY_FLAVOR	デイジーの記憶の断片が刻まれた、思念<br>の結晶。この結晶を所持する者とデイジ<br>ーの想いが共鳴した際、錬金術による幻<br>影兵の行使に近しい力を一時借り受ける<br>ことができる。
PM_RICHE_FLAVOR	リッシュの記憶の断片が刻まれた、思念<br>の結晶。この結晶を所持する者とリッシ<br>ュの想いが共鳴した際、錬金術による幻<br>影兵の行使に近しい力を一時借り受ける<br>ことができる。
PM_REGEN_FLAVOR	レーゲンの記憶の断片が刻まれた、思念<br>の結晶。この結晶を所持する者とレーゲ<br>ンの想いが共鳴した際、錬金術による幻<br>影兵の行使に近しい力を一時借り受ける<br>ことができる。
PM_YUDIT_FLAVOR	ユーディットの記憶の断片が刻まれた、<br>思念の結晶。この結晶を所持する者とユ<br>ーディットの想いが共鳴した際、錬金術<br>による幻影兵の行使に近しい力を一時借<br>り受けることができる。
PM_LOREAM_FLAVOR	ローレアムの記憶の断片が刻まれた、思<br>念の結晶。この結晶を所持する者とロー<br>レアムの想いが共鳴した際、錬金術によ<br>る幻影兵の行使に近しい力を一時借り受<br>けることができる。
PM_MARIANNU_FLAVOR	マリアンヌの記憶の断片が刻まれた、思<br>念の結晶。この結晶を所持する者とマリ<br>アンヌの想いが共鳴した際、錬金術によ<br>る幻影兵の行使に近しい力を一時借り受<br>けることができる。
PM_DAPHNE_02_FLAVOR	ダフネの記憶の断片が刻まれた、思念の<br>結晶。この結晶を所持する者とダフネの<br>想いが共鳴した際、錬金術による幻影兵<br>の行使に近しい力を一時借り受けること<br>ができる。
PM_SHANGDI_FLAVOR	シャンディの記憶の断片が刻まれた、思<br>念の結晶。この結晶を所持する者とシャ<br>ンディの想いが共鳴した際、錬金術によ<br>る幻影兵の行使に近しい力を一時借り受<br>けることができる。
PM_NIDOHEGAL_FLAVOR	ニドヘガルの記憶の断片が刻まれた、思<br>念の結晶。この結晶を所持する者とニド<br>ヘガルの想いが共鳴した際、錬金術によ<br>る幻影兵の行使に近しい力を一時借り受<br>けることができる。
PM_LILLE_FLAVOR	リルの記憶の断片が刻まれた、思念の結<br>晶。この結晶を所持する者とリルの想い<br>が共鳴した際、錬金術による幻影兵の行<br>使に近しい力を一時借り受けることがで<br>きる。
PM_CLARIS_FLAVOR	クラリスの記憶の断片が刻まれた、思念<br>の結晶。この結晶を所持する者とクラリ<br>スの想いが共鳴した際、錬金術による幻<br>影兵の行使に近しい力を一時借り受ける<br>ことができる。
PM_NASARIO_FLAVOR	ナサリオの記憶の断片が刻まれた、思念<br>の結晶。この結晶を所持する者とナサリ<br>オの想いが共鳴した際、錬金術による幻<br>影兵の行使に近しい力を一時借り受ける<br>ことができる。
PM_INES_FLAVOR	イネスの記憶の断片が刻まれた、思念の<br>結晶。この結晶を所持する者とイネスの<br>想いが共鳴した際、錬金術による幻影兵<br>の行使に近しい力を一時借り受けること<br>ができる。
PM_RION_FLAVOR	リオンの記憶の断片が刻まれた、思念の<br>結晶。この結晶を所持する者とリオンの<br>想いが共鳴した際、錬金術による幻影兵<br>の行使に近しい力を一時借り受けること<br>ができる。
PM_CLARIS_02_FLAVOR	クラリスの記憶の断片が刻まれた、思念<br>の結晶。この結晶を所持する者とクラリ<br>スの想いが共鳴した際、錬金術による幻<br>影兵の行使に近しい力を一時借り受ける<br>ことができる。
PM_MASIA_FLAVOR	マーシアの記憶の断片が刻まれた、思念<br>の結晶。この結晶を所持する者とマーシ<br>アの想いが共鳴した際、錬金術による幻<br>影兵の行使に近しい力を一時借り受ける<br>ことができる。
PM_RAT_FLAVOR	ラットンの記憶の断片が刻まれた、思念<br>の結晶。この結晶を所持する者とラット<br>ンの想いが共鳴した際、結晶を構成する<br>アルケミィが反応し、錬金術の強大な力<br>を一時借り受けることができる。
PM_WOLF_ARM_FLAVOR	レッドウルフの記憶の断片が刻まれた、<br>思念の結晶。この結晶を所持する者とレ<br>ッドウルフの想いが共鳴した際、結晶を<br>構成するアルケミィが反応し、錬金術の<br>強大な力を一時借り受けることができる<br>。
PM_DEMON_WIZ_FLAVOR	魔人の記憶の断片が刻まれた、思念の結<br>晶。この結晶を所持する者と魔人の想い<br>が共鳴した際、結晶を構成するアルケミ<br>ィが反応し、錬金術の強大な力を一時借<br>り受けることができる。
PM_RUI_FLAVOR	ルイの記憶の断片が刻まれた、思念の結<br>晶。この結晶を所持する者とルイの想い<br>が共鳴した際、錬金術による幻影兵の行<br>使に近しい力を一時借り受けることがで<br>きる。
PM_AZAMI_FLAVOR	アザミの記憶の断片が刻まれた、思念の<br>結晶。この結晶を所持する者とアザミの<br>想いが共鳴した際、錬金術による幻影兵<br>の行使に近しい力を一時借り受けること<br>ができる。
PM_RIZA_FLAVOR	リザの記憶の断片が刻まれた、思念の結<br>晶。この結晶を所持する者とリザの想い<br>が共鳴した際、錬金術による幻影兵の行<br>使に近しい力を一時借り受けることがで<br>きる。
PM_BEELZ_C01_FLAVOR	虚ろなる〈暴食〉の猛豚の記憶の断片が<br>刻まれた、思念の結晶。この結晶を所持<br>する者と虚ろなる〈暴食〉の猛豚の想い<br>が共鳴した際、結晶を構成するアルケミ<br>ィが反応し、錬金術の強大な力を一時借<br>り受けることができる。
PM_ASMO_C01_FLAVOR	虚ろなる〈色欲〉の剛山羊の記憶の断片<br>が刻まれた、思念の結晶。この結晶を所<br>持する者と虚ろなる〈色欲〉の剛山羊の<br>想いが共鳴した際、結晶を構成するアル<br>ケミィが反応し、錬金術の強大な力を一<br>時借り受けることができる。
PM_BELP_C01_FLAVOR	虚ろなる〈怠惰〉の雄熊の記憶の断片が<br>刻まれた、思念の結晶。この結晶を所持<br>する者と虚ろなる〈怠惰〉の雄熊の想い<br>が共鳴した際、結晶を構成するアルケミ<br>ィが反応し、錬金術の強大な力を一時借<br>り受けることができる。
PM_ENANZI_FLAVOR	エナンジの記憶の断片が刻まれた、思念<br>の結晶。この結晶を所持する者とエナン<br>ジの想いが共鳴した際、錬金術による幻<br>影兵の行使に近しい力を一時借り受ける<br>ことができる。
PM_MATHIAS_02_FLAVOR	マティアの記憶の断片が刻まれた、思念<br>の結晶。この結晶を所持する者とマティ<br>アの想いが共鳴した際、錬金術による幻<br>影兵の行使に近しい力を一時借り受ける<br>ことができる。
PM_SELJUKLU_FLAVOR	セルジークの記憶の断片が刻まれた、思<br>念の結晶。この結晶を所持する者とセル<br>ジークの想いが共鳴した際、錬金術によ<br>る幻影兵の行使に近しい力を一時借り受<br>けることができる。
PM_HELENE_02_FLAVOR	ヘレネーの記憶の断片が刻まれた、思念<br>の結晶。この結晶を所持する者とヘレネ<br>ーの想いが共鳴した際、錬金術による幻<br>影兵の行使に近しい力を一時借り受ける<br>ことができる。
PM_OPHINEUS_FLAVOR	オピネウスの記憶の断片が刻まれた、思<br>念の結晶。この結晶を所持する者とオピ<br>ネウスの想いが共鳴した際、錬金術によ<br>る幻影兵の行使に近しい力を一時借り受<br>けることができる。
PM_SCHMEIER_02_FLAVOR	シュメイアの記憶の断片が刻まれた、思<br>念の結晶。この結晶を所持する者とシュ<br>メイアの想いが共鳴した際、錬金術によ<br>る幻影兵の行使に近しい力を一時借り受<br>けることができる。
PM_UROBOROS_NEW_FLAVOR	ウロボロスの記憶の断片が刻まれた、思<br>念の結晶。この結晶を所持する者とウロ<br>ボロスの想いが共鳴した際、錬金術によ<br>る幻影兵の行使に近しい力を一時借り受<br>けることができる。
PM_SUMERAGI_FLAVOR	スメラギの記憶の断片が刻まれた、思念<br>の結晶。この結晶を所持する者とスメラ<br>ギの想いが共鳴した際、錬金術による幻<br>影兵の行使に近しい力を一時借り受ける<br>ことができる。
PM_MIKABOSI_FLAVOR	ミカボシの記憶の断片が刻まれた、思念<br>の結晶。この結晶を所持する者とミカボ<br>シの想いが共鳴した際、錬金術による幻<br>影兵の行使に近しい力を一時借り受ける<br>ことができる。
PM_AGATHA_NEW_FLAVOR	アガサの記憶の断片が刻まれた、思念の<br>結晶。この結晶を所持する者とアガサの<br>想いが共鳴した際、錬金術による幻影兵<br>の行使に近しい力を一時借り受けること<br>ができる。
