TITLE	Help
BACK_BUTTON	Back
MENU_L_NUM	11
MENU_NUM	118
MENU_CATE_1	World Lore
MENU_1	What is THE ALCHEMIST CODE?
MAIN_TITLE_1	What is THE ALCHEMIST CODE?
MAIN_TEXT_1	Mankind's Will is at the mere mercy of the Stones of Gods. History is woven as a continuation of the people's creation and loss. These are the memories of man crossing paths with The Stone at the source of all creation. This is a tactical RPG, built around the concept of a human drama following 7 protagonists from 7 different nations. 
MENU_CATE_2	World Lore
MENU_2	Alchemy
MAIN_TITLE_2	Alchemy
MAIN_TEXT_2	Alchemy allows its users to create anything in exchange for something of equal value. Even the usage of souls is no exception. Warriors and heroes of the past can be manifested in reality through transmutation of souls. They are specifically called Phantoms.
MENU_CATE_3	World Lore
MENU_3	Phantoms
MAIN_TITLE_3	Phantoms
MAIN_TEXT_3	The manifestations of the transmutation of souls of warriors or heroes of the past through Alchemy. They are specifically called Phantoms.
MENU_CATE_4	World Lore
MENU_4	Nimul and Emmel
MAIN_TITLE_4	Nimul and Emmel
MAIN_TEXT_4	Long ago in the distant past, there were two who aimed to become gods. They were Nimul and Emmel, brother and sister considered to be the founders of Alchemy. It is said that they used forbidden arts to build a tower that rose to the heavens.
MENU_CATE_5	World Lore
MENU_5	Tower of Babel
MAIN_TITLE_5	Tower of Babel
MAIN_TEXT_5	The sky-piercing tower which Nimul and Emmel, the founders of Alchemy, built using their power. It rises in the middle of the continent and can be seen from any of the land's kingdoms. It now stands as a symbol for the great foolish sin mankind has committed. 
MENU_CATE_6	World Lore
MENU_6	Continent of Babel
MAIN_TITLE_6	Continent of Babel
MAIN_TEXT_6	The Continent of Babel is comprised of the far-reaching lands beneath the Tower of Babel, within which the Kingdom of Northern Pride holds a leading function. Located to the North is Slothstein, there are Lustburg and Greed Dike to the East, and Envylia, Old Wratharis and the Desert Zone to the West. Gluttony Foss and the Saga Region are spread out to the North of the Desert Zone.
MENU_CATE_7	World Lore
MENU_7	Seven Kingdoms of Babel
MAIN_TITLE_7	Seven Kingdoms of Babel
MAIN_TEXT_7	Long ago, there was a war between the Seven Kingdoms of the Babel Continent, in which Alchemy was used as a weapon. Because of its enormous destruction, and sensing its threat to human kind, the Nations of Babel formed the Alliance of the Seven Kingdoms, led by the suzerain state of Northern Pride. They branded Alchemy as the Forbidden Art.
MENU_CATE_8	World Lore
MENU_8	Philosopher's Stone
MAIN_TITLE_8	Philosopher's Stone
MAIN_TEXT_8	It is said that anyone who obtains a Philosopher's Stone can use the Forbidden Art of Alchemy.
MENU_CATE_9	World Lore
MENU_9	Ouroboros
MAIN_TITLE_9	Ouroboros
MAIN_TEXT_9	Ouroboros exists in another dimension called the Door of Truth. She is only visible however to anyone who has made a pact with the Door of Truth. By making a pact with Ouroboros, one obtains the power of Alchemy, the Forbidden Art, and can create all things, even without using a Philosopher's Stone.
MENU_CATE_10	World Lore
MENU_10	Door of Truth
MAIN_TITLE_10	Door of Truth
MAIN_TEXT_10	The Door of Truth is the dimension where pacts are made with Ouroboros. Strong souls who come in touch with a Philosopher's Stone can be called to the Door of Truth. By making a pact with Ouroboros, one can obtain the Forbidden Art. It is said however, that when one's willpower and soul collapses, one's soul gets swallowed by the Door of Truth as compensation for the pact.
MENU_CATE_11	Quests
MENU_11	About Story Quests
MAIN_TITLE_11	About Story Quests
MAIN_TEXT_11	Story Quests are divided into Normal and Hard difficulty modes. By completing specific Normal quests, the Hard version is unlocked. Hard quests sometimes reward you with unit Soul Shards.
MENU_CATE_12	Quests
MENU_12	About Period-Exclusive Quests
MAIN_TITLE_12	About Period-Exclusive Quests
MAIN_TEXT_12	Apart from Story Quests, there are 3 Period-Exclusive quests which are exclusive to certain time slots.<br>■Apple Garden: Obtain items that raise Unit Exp.<br>▼Time Slots<br>7AM - 8AM<br>12AM - 1PM<br>6PM - 7PM<br>10PM - 11PM<br><br>■Gold Rush (Weekend Event): Obtain items that you can sell for Zeni.<br>▼Time Period<br>Playable on Sat & Sun from 0:00AM - 11:59PM.
MENU_CATE_13	Quests
MENU_13	About Weekly Quests
MAIN_TITLE_13	About Weekly Quests
MAIN_TEXT_13	THE ALCHEMIST CODE features the following 6 Weekly Quests.<br>■On Tue-Wed-Thu: Obtain Golem / Goddess / Alchemia Evolve Items.<br>■On Fri-Sat-Sun: Obtain Token Items which are necessary for any Job Changes.
MENU_CATE_14	Quests
MENU_14	Quest Mission (Completion Reward)
MAIN_TITLE_14	Quest Mission (Completion Reward)
MAIN_TEXT_14	Story Quests come with 3 Quest Missions with their own completion requirements. By completing these requirements, you can obtain the corresponding Completion Rewards. Quest Mission Rewards can only be received the first time you complete the requirements.
MENU_CATE_15	Quests
MENU_15	About AP
MAIN_TITLE_15	About AP
MAIN_TEXT_15	AP is spent by taking on quests, etc. AP is replenished through time (1 point every 6m), and can also be replenished by spending Gems.<br>■Required Gems for AP replenishment<br>1st Time: 50 Gems<br>2nd-4th Time: 100 Gems<br>5th-6th Time: 200 Gems<br><br>■Replenished Amount<br>Each replenishment replenishes 120AP, up to a max of 1000AP.<br>*If your Max AP is under 120, replenishing AP will bring your AP above this limit.<br>Example: If your Max AP is 20, your AP will result in 20+120 (1 replenishment) = 140AP.<br>*If your AP is above your Max AP, your AP will not replenish over time until it falls below your Max AP limit.<br>Also, note that you cannot play any stages with AP cost higher than your Max AP.
MENU_CATE_16	Quests
MENU_16	Party Setup
MAIN_TITLE_16	Party Setup
MAIN_TEXT_16	In Story Quests, you can set up a party of max 7 units, consisting of 1 protagonist, 3 main units, 1 mercenary and 2 sub units to substitute units that go down in battle.
MENU_CATE_17	Quests
MENU_17	About Mercenaries
MAIN_TITLE_17	About Mercenaries
MAIN_TEXT_17	Mercenaries are units which you can use in exchange for Zeni. The cost of hiring a mercenary is in accordance to its level. If the mercenary is owned by a friend however, the hiring cost is halved. Note that mercenaries up to Lv10 don't require a hiring fee.
MENU_CATE_18	Quests
MENU_18	About Sub Units
MAIN_TITLE_18	About Sub Units
MAIN_TEXT_18	Sub Units are units who will join the battle if any of your main units go down. In Story Quests, you can take along 2 Sub Units.
MENU_CATE_19	Quests
MENU_19	Total ATK
MAIN_TITLE_19	Total ATK
MAIN_TEXT_19	Total ATK is the subtotal offensive power of all units in your party. It's a good idea to aim for the highest Total ATK value, while keeping in mind a good job balance.
MENU_CATE_20	Quests
MENU_20	Item Setup
MAIN_TITLE_20	Item Setup
MAIN_TEXT_20	 
MENU_CATE_21	Quests
MENU_21	About Turn Order
MAIN_TITLE_21	About Turn Order
MAIN_TEXT_21	The turn order in a battle is determined by the AGI value of your units and your foes. The turn order is also influenced by certain factors, whether units have moved, attacked, or used abilities / items, etc. during their turn.
MENU_CATE_22	Quests
MENU_22	Unit Movement
MAIN_TITLE_22	Unit Movement
MAIN_TEXT_22	Unit movement Area and moveable height range is dependent on a unit's job. It's a good idea to take a look at the jobs' specific movement capabilities, in order to use these to your strategic advantage.
MENU_CATE_23	Quests
MENU_23	Terrain Height
MAIN_TITLE_23	Terrain Height
MAIN_TEXT_23	 
MENU_CATE_24	Quests
MENU_24	Unit Orientation
MAIN_TITLE_24	Unit Orientation
MAIN_TEXT_24	Enemy units will try to attack your units from the back, so it's effective to face your back towards a wall or face the backs of several of your units together.
MENU_CATE_25	Quests
MENU_25	Waiting for Turn (WT)
MAIN_TITLE_25	Waiting for Turn (WT)
MAIN_TEXT_25	 
MENU_CATE_26	Quests
MENU_26	Active Turn (AT)
MAIN_TITLE_26	Active Turn (AT)
MAIN_TEXT_26	 
MENU_CATE_27	Quests
MENU_27	Soul Jewels
MAIN_TITLE_27	Soul Jewels
MAIN_TEXT_27	These are required to activate abilities, and they are obtained when attacking foes or using abilities on them. Also, note that the acquired amount of Soul Jewels differs whether you attack a foe from the front, side or back.
MENU_CATE_28	Quests
MENU_28	Magic - Setting a Target
MAIN_TITLE_28	Magic - Setting a Target
MAIN_TEXT_28	When using magical skills, you can choose to either target a unit or the grid. If you choose to target a unit, your ability will target this unit, even if they have moved to a different spot. When choosing to target the grid, your magic will miss the target if your intended target moved away from the targeted area, but it will affect any units who will have moved into the targeted area.
MENU_CATE_29	Quests
MENU_29	About Using Magic
MAIN_TITLE_29	About Using Magic
MAIN_TEXT_29	 
MENU_CATE_30	Quests
MENU_30	About Using Items
MAIN_TITLE_30	About Using Items
MAIN_TEXT_30	If you've used up a certain item in battle, this item will automatically get replenished for the next battle as long as you still possess any.
MENU_CATE_31	Quests
MENU_31	About Elements
MAIN_TITLE_31	About Elements
MAIN_TEXT_31	 
MENU_CATE_32	Quests
MENU_32	Battle Forecast
MAIN_TITLE_32	Battle Forecast
MAIN_TEXT_32	When executing a regular attack, the attack's estimated damage value will be displayed. The actual damage is dealt in a certain margin from the estimated damage value, so the actual damage may differ from the displayed value.
MENU_CATE_33	Quests
MENU_33	About Critical Hits
MAIN_TITLE_33	About Critical Hits
MAIN_TEXT_33	According to a unit's CRIT value, it may sometimes deliver a critical hit, which is an attack that deals more damage than a regular hit. The higher the CRIT value, the higher the probability of a critical hit.
MENU_CATE_34	Quests
MENU_34	About Combo Attacks
MAIN_TITLE_34	About Combo Attacks
MAIN_TEXT_34	When a friendly unit is nearby, it's sometimes possible to execute a Combo Attack. The higher a unit's COMBO value, the higher the probability of a Combo Attack. Note that you can increase a unit's COMBO value through Limit Break. This will also increase the COMBO Area.
MENU_CATE_35	Quests
MENU_35	Unit Defeat (KO)
MAIN_TITLE_35	Unit Defeat (KO)
MAIN_TEXT_35	You lose a battle when your protagonist reaches 0 HP, or if all your units have fallen. If you've set up sub units however, they will enter battle to substitute fallen units, and the battle will continue.
MENU_CATE_36	Quests
MENU_36	About Viewpoint Switching
MAIN_TITLE_36	About Viewpoint Switching
MAIN_TEXT_36	It is possible to rotate the map and switch the camera viewpoint. By using this function and rotating the map, you can make spots more visible that might have been difficult to see from the initial angle.
MENU_CATE_37	Quests
MENU_37	Auto Battle
MAIN_TITLE_37	Auto Battle
MAIN_TEXT_37	Auto Battle can be enabled after clearing a quest once. When Auto Battle is enabled, the battle will proceed automatically. You can set this up from the menu in the upper right corner of the screen.
MENU_CATE_38	Quests
MENU_38	Retreat
MAIN_TITLE_38	Retreat
MAIN_TEXT_38	If you want to abort an ongoing battle, you can do so by selecting Retreat from the menu in the upper right corner of the screen. When retreating, some of the AP you spent on this quest will be reimbursed. When you retreat at the very end of a battle, it's possible that you won't receive any AP back.
MENU_CATE_39	Quests
MENU_39	Soul Jewels on the Map
MAIN_TITLE_39	Soul Jewels on the Map
MAIN_TEXT_39	You can sometimes obtain Soul Jewels from the map. When picking up some of these Soul Jewels, they don't only increase your Soul Jewels, but they may also bestow a bonus effect to your units during battle.
MENU_CATE_40	Quests
MENU_40	Treasure Chests on the Map
MAIN_TITLE_40	Treasure Chests on the Map
MAIN_TEXT_40	You can pick up a Treasure on the map by moving to its location and ending your turn. This will increase the amount of items you can obtain throughout a quest. Try to coordinate the battle in a way that you can obtain these treasures before the end of battle.
MENU_CATE_41	Quests
MENU_41	Continuing
MAIN_TITLE_41	Continuing
MAIN_TEXT_41	When you've lost a battle, it's possible to use Gems to Continue from the point right before your defeat, with all of your units restored to full HP.
MENU_CATE_42	Quests
MENU_42	About Skip Tickets
MAIN_TITLE_42	About Skip Tickets
MAIN_TEXT_42	You can use Skip Tickets to clear a quest and skip the battle, while still spending AP and obtaining the EXP and items. Skip Tickets can be used with Story Quests and some Event Quests.
MENU_CATE_43	Quests
MENU_43	Player Level Up
MAIN_TITLE_43	Player Level Up
MAIN_TEXT_43	As you go on gaining Player EXP, you can increase your Player Level. You can earn Player EXP by clearing Story Quests. You can earn high amounts of Player EXP by completing Daily and Milestone missions.
MENU_CATE_44	Quests
MENU_44	Unit Level Up
MAIN_TITLE_44	Unit Level Up
MAIN_TEXT_44	As you go on gaining Unit EXP, you can increase the level of your units. You can earn Unit EXP by clearing Story Quests, and by using Unit EXP Items. Bear in mind however, that you cannot raise Unit Lv higher than your Player Lv.
MENU_CATE_45	Quests
MENU_45	Items Obtained
MAIN_TITLE_45	Items Obtained
MAIN_TEXT_45	Items Obtained indicates the items you've obtained in a quest by defeating foes, collecting treasures, and any rewards you've earned from fulfilling the Quest Mission completion requirements.
MENU_CATE_46	Quests
MENU_46	Player EXP
MAIN_TITLE_46	Player EXP
MAIN_TEXT_46	Player EXP can be obtained by clearing Missions and Story Quests, etc. Player EXP is required to increase your Player Level.
MENU_CATE_47	Quests
MENU_47	Unit EXP
MAIN_TITLE_47	Unit EXP
MAIN_TEXT_47	Unit EXP can be obtained by using Apple items and clearing Story Quests, etc. Unit EXP is required to increase the level of your units.
MENU_CATE_48	Units
MENU_48	Enhance Unit
MAIN_TITLE_48	Enhance Unit
MAIN_TEXT_48	 
MENU_CATE_49	Units
MENU_49	Evolve
MAIN_TITLE_49	Evolve
MAIN_TEXT_49	You can evolve a unit to increase its rarity. A unit's evolution limit is determined by its number of ☆. Evolving a unit requires it to be at Max Lv, while also requiring Zeni and Evolve Materials. Evolve Materials are obtained through Weekly Quests, etc.<br><br>Evolving Lv requirements:<br>1☆->2☆ Lv10<br>2☆->3☆ Lv20<br>3☆->4☆ Lv30<br>4☆->5☆ Lv50<br>*Bear in mind that you cannot raise Unit Lv higher than your Player Lv.
MENU_CATE_50	Units
MENU_50	Limit Break
MAIN_TITLE_50	Limit Break
MAIN_TEXT_50	 
MENU_CATE_51	Units
MENU_51	What are Soul Shards?
MAIN_TITLE_51	What are Soul Shards?
MAIN_TEXT_51	Soul Shards are items which are required for unit Limit Break. It's also possible to collect Soul Shards to Transmute a unit. They can be obtained through shops or summoning.<br>*When summoning a unit which you already own, you will instead receive a number of Soul Shards in accordance to its rarity.<br><br>■Soul Shards obtained according to rarity<br>★★★ => 15 Shards<br>★★★★ => 20 Shards<br>★★★★★ => 25 Shards
MENU_CATE_52	Units
MENU_52	Job
MAIN_TITLE_52	Job
MAIN_TEXT_52	Jobs indicate a unit's profession type. Jobs are divided into frontline, midline and backline. Each unit has at least 2 jobs, though any jobs other than the initial jobs have to be unlocked. In order to unlock a job, you have to reach a certain Limit Break Lv.
MENU_CATE_53	Units
MENU_53	Job Level
MAIN_TITLE_53	Job Level
MAIN_TEXT_53	 
MENU_CATE_54	Units
MENU_54	Unlock Job
MAIN_TITLE_54	Unlock Job
MAIN_TEXT_54	 
MENU_CATE_55	Units
MENU_55	Job Change
MAIN_TITLE_55	Job Change
MAIN_TEXT_55	Changing a unit's job is possible by raising Limit Break to a certain level, equipping a specified Job Token, and unlocking the specified job.
MENU_CATE_56	Units
MENU_56	Impact of Different Jobs
MAIN_TITLE_56	Impact of Different Jobs
MAIN_TEXT_56	A unit's job determines its abilities and specific stat distribution.<br>Example: Thief<br>Thieves are support-orientated and move around the battlefield with their high AGI and JUMP capabilities.<br>Advantage: Increased AGI and DEX<br>Penalty: Decreased HP
MENU_CATE_57	Units
MENU_57	About Job Attack Types
MAIN_TITLE_57	About Job Attack Types
MAIN_TEXT_57	Job attack types are as follows:<br><br>[Slash]<br>Soldier, Holy Knight, Holy Cavalier, Dark Knight, Dark Cavalier, Magic Swordsman, Twin-Blade Swordsman, Thief, Ninja, Samurai, Dancer, Bride, Bridegroom, Pirate, Warrior, Astrologer, Necromancer, Blademaster, Martial Master<br><br>[Pierce]<br>Spearman, Dragon Knight, Dragon Cavalier, Valkyrie, Sacred Lancer<br><br>[Strike]<br>Martial Artist, Holy Brawler, Shrine Maiden, Priest, Bishop, Enchanter, Mage, Magician, Sage, Summoner, Merchant, Blacksmith, Priestess, Battle Mage<br><br>[Missile]<br>Hunter, Gunner, Sniper, Crafter, Machinist, Drifter, Ranger, Magia Gunslinger<br><br>[Special]<br>Beast Tamer, Chemist, Professor, Bard
MENU_CATE_58	Units
MENU_58	Enhance Ability
MAIN_TITLE_58	Enhance Ability
MAIN_TEXT_58	 
MENU_CATE_59	Units
MENU_59	Ability Setup
MAIN_TITLE_59	Ability Setup
MAIN_TEXT_59	 
MENU_CATE_60	Units
MENU_60	Leader Skill
MAIN_TITLE_60	Leader Skill
MAIN_TEXT_60	Units with a rarity of 3+★ possess a Leader Skill. By putting a leader skill to good use, you can bestow various bonuses to the units in your party. (Stat bonuses, etc.)
MENU_CATE_61	Units
MENU_61	Friend Skills
MAIN_TITLE_61	Friend Skills
MAIN_TEXT_61	A Friend Skill indicates the bonus effect which can be obtained by hiring a friend's unit with a leader skill as your mercenary.
MENU_CATE_62	Units
MENU_62	Action Abilities
MAIN_TITLE_62	Action Abilities
MAIN_TEXT_62	Action Abilities are job-specific abilities which a player can choose to use during battle. In order to use Action Abilities however, a certain amount of Soul Jewels is required.
MENU_CATE_63	Units
MENU_63	Reaction Abilities
MAIN_TITLE_63	Reaction Abilities
MAIN_TEXT_63	<br><br><br>Reaction Abilities are abilities which are activated when a unit suffers an attack. You can only set one Reaction Ability per unit.
MENU_CATE_64	Units
MENU_64	Support Abilities
MAIN_TITLE_64	Support Abilities
MAIN_TEXT_64	Support Abilities are non-offensive abilities which bestow units with special bonuses. You can set a maximum of 2 Support Abilities per unit. You cannot set the same Support Ability twice, however. Also, bear in mind that certain abilities only affect certain jobs.<br>(Example: Hawk Eye: Range +1 -> Affects only missile-type jobs)
MENU_CATE_65	Units
MENU_65	About Equipment
MAIN_TITLE_65	About Equipment
MAIN_TEXT_65	Equipping items allows you to increase a unit's stats.<br>(Color legend)<br>Green: You own this item and meet the Lv Req.<br>Yellow: You own this item, but do not meet the Lv Req.<br>None: Item not owned.<br>If you don't own an item, but if you can craft it through material fusion, a yellow + will be displayed.
MENU_CATE_66	Units
MENU_66	About Equipment Items
MAIN_TITLE_66	About Equipment Items
MAIN_TEXT_66	Equipment items are equippable items which can be obtained through quests, or purchased at shops. Equipping items increases a unit's parameters. Equippable items are dependent on a unit's job however, and once an item is equipped, it cannot be removed.
MENU_CATE_67	Units
MENU_67	Enhance Equipment
MAIN_TITLE_67	Enhance Equipment
MAIN_TEXT_67	Tap Enhance Equipment at the shop to enhance a unit's equipment items. This increases the item's stats. Enhancing equipment requires Zeni and Enhancement Materials.<br>When raising a job's level, these bonus stats will not be carried over. 
MENU_CATE_68	Units
MENU_68	What are Enhancement Points?
MAIN_TITLE_68	What are Enhancement Points?
MAIN_TEXT_68	Enhancement Points are points which are required to Enhance Equipment. All enhancement materials contain a certain amount of Enhancement Points. You can proceed with an enhancement once you've exceeded a certain amount of Enhancement Points. (Example: Lv1 -> Lv2)  
MENU_CATE_69	Units
MENU_69	Returned Enhancement Item
MAIN_TITLE_69	Returned Enhancement Item
MAIN_TEXT_69	If you had any enhanced items when increasing job level, you may get some of the enhancement materials (Alchemia Pots, etc.) which you used to enhance this item returned to you.
MENU_CATE_70	Units
MENU_70	Fuse Materials
MAIN_TITLE_70	Fuse Materials
MAIN_TEXT_70	Some equipment items can be crafted by fusing materials. Equipment items and materials can be obtained through quests and period-exclusive quests, etc. Some items and materials can also be bought at shops.<br>Fuse materials to craft items by going to Units > Job, and tapping the equipment icon.
MENU_CATE_71	Gear
MENU_71	What is Gear?
MAIN_TITLE_71	What is Gear?
MAIN_TEXT_71	You can hold a maximum of 300 gear items. Any gear obtained exceeding this limit will be automatically converted into shards.
MENU_CATE_72	Gear
MENU_72	What is Gear Transmutation?
MAIN_TITLE_72	What is Gear Transmutation?
MAIN_TEXT_72	 
MENU_CATE_73	Gear
MENU_73	What is Gear Enhancement?
MAIN_TITLE_73	What is Gear Enhancement?
MAIN_TEXT_73	 
MENU_CATE_74	Gear
MENU_74	What is Gear Evolution?
MAIN_TITLE_74	What is Gear Evolution?
MAIN_TEXT_74	 
MENU_CATE_75	Gear
MENU_75	What is Gear Disassembly?
MAIN_TITLE_75	What is Gear Disassembly?
MAIN_TEXT_75	 
MENU_CATE_76	Gear
MENU_76	Equipping Gear
MAIN_TITLE_76	Equipping Gear
MAIN_TEXT_76	 
MENU_CATE_77	Arena
MENU_77	Arena Rules
MAIN_TITLE_77	Arena Rules
MAIN_TEXT_77	The Arena is an automatic battle against another player (max 3 vs 3 units). Players set up a party and battle their opponent. The surviving team wins the battle. However, if you cannot beat your opponent within the turn limit, the defending team wins.
MENU_CATE_78	Arena
MENU_78	BP
MAIN_TITLE_78	BP
MAIN_TEXT_78	You can have a maximum of 5BP (Battle Points), and 1BP is spent for every arena battle. BP is reset every day at midnight.
MENU_CATE_79	Arena
MENU_79	Team Setup
MAIN_TITLE_79	Team Setup
MAIN_TEXT_79	When challenging another player for battle, your ATK Team Setup will be used. When someone challenges you on the other hand, your DEF Team Setup will be used. 
MENU_CATE_80	Arena
MENU_80	Arena Ranking
MAIN_TITLE_80	Arena Ranking
MAIN_TEXT_80	Through Arena Ranking, you can check the Total Ranking of all players who have participated in the arena. Both ATK/DEF battle results are documented in this ranking.
MENU_CATE_81	Arena
MENU_81	About Ranking Rewards
MAIN_TITLE_81	About Ranking Rewards
MAIN_TEXT_81	Some rewards are obtainable by improving your personal highest ranking, while some can be obtained through daily ranking. Rewards for daily rankings are based on the specific ranking at 8PM every day.
MENU_CATE_82	Arena
MENU_82	History
MAIN_TITLE_82	History
MAIN_TEXT_82	View your battle history both as an attacker (ATK) and as a defender (DEF).
MENU_CATE_83	Arena
MENU_83	What are Arena Coins?
MAIN_TITLE_83	What are Arena Coins?
MAIN_TEXT_83	Arena Coins are coins which are only useable at the arena's special Exchange Shop, where they can be exchanged for items. You can obtain arena coins by winning arena battles. You can check how many arena coins you own at the Exchange Shop.
MENU_CATE_84	Arena
MENU_84	Exchange Shop (Arena)
MAIN_TITLE_84	Exchange Shop (Arena)
MAIN_TEXT_84	At the Arena Exchange Shop, you can exchange Arena Coins obtained at the arena for items. You can also exchange them for Unit Soul Shards and Tokens, etc.
MENU_CATE_85	Multiplay
MENU_85	What is Multiplay?
MAIN_TITLE_85	What is Multiplay?
MAIN_TEXT_85	In Multiplay, you can team up with up to 4 people to enter quest battles together. The objective is to eliminate all foes. On the other hand, you will lose the battle if all player units have fallen.
MENU_CATE_86	Multiplay
MENU_86	Multiplay Quest Rules
MAIN_TITLE_86	Multiplay Quest Rules
MAIN_TEXT_86	The rules of Multiplay Quests are as follows.<br>■Every player has 10s time to act from start of turn, +10s when moving, and +10s when selecting an action. If this time limit is breached, the unit will act automatically.<br>■You cannot carry any items.<br>■When victorious, every player will receive the items obtained.
MENU_CATE_87	Multiplay
MENU_87	About Joining Multiplay
MAIN_TITLE_87	About Joining Multiplay
MAIN_TEXT_87	There are 2 methods to join Multiplay.<br>■Recruiting a Party: Create a party and invite other players.<br>■Joining a Party: Join a party created by another player.<br>Tap Refresh Rooms in order to refresh the party list.  
MENU_CATE_88	Multiplay
MENU_88	Recruitment Method 1: Nearby Players
MAIN_TITLE_88	Recruitment Method 1: Nearby Players
MAIN_TEXT_88	By choosing to recruit Nearby Players, location data will be used to recruit players located near you. In order to use this function, please set the Location Data Functionality to Approve. 
MENU_CATE_89	Multiplay
MENU_89	Recruitment Method 2: On LINE
MAIN_TITLE_89	Recruitment Method 2: On LINE
MAIN_TEXT_89	By choosing to recruit On LINE, you can use LINE to invite your LINE friends. To use this function, you require a LINE account, and you need to be in an area where LINE can be used.
MENU_CATE_90	Multiplay
MENU_90	Restricted
MAIN_TITLE_90	Restricted
MAIN_TEXT_90	Apart from creating a Multiplay room where anyone can freely enter, it's also possible to set up an entry Code, thus making it exclusive to friends. By setting Restricted to On, a Code will get automatically issued. You can then share this code to your friends.
MENU_CATE_91	Multiplay
MENU_91	Job Change MP Quest
MAIN_TITLE_91	Job Change MP Quest
MAIN_TEXT_91	Job Change MP Quests are Multiplay Quests where you can obtain Tokens, which are required for job changes. If you're looking for Tokens, this is the place to be.
MENU_CATE_92	Multiplay
MENU_92	Evolution MP Quest
MAIN_TITLE_92	Evolution MP Quest
MAIN_TEXT_92	Evolution MP Quests are Multiplay Quests where you can obtain Evolve Materials, which are required for Evolving. If you're looking for Evolve Materials, this is the place to be.
MENU_CATE_93	Multiplay
MENU_93	What are Multi Coins?
MAIN_TITLE_93	What are Multi Coins?
MAIN_TEXT_93	Multi Coins are coins which are only useable at the special Multiplay Exchange Shop. They can be obtained by clearing Multiplay Quests. Once you've saved up some Multi Coins, you can exchange them for items at the Exchange Shop.
MENU_CATE_94	Multiplay
MENU_94	Exchange Shop (Multiplay)
MAIN_TITLE_94	Exchange Shop (Multiplay)
MAIN_TEXT_94	At the Multiplay Exchange Shop, you can exchange Multi Coins obtained through Multiplay Quests for items. You can also exchange them for Unit Soul Shards, etc.
MENU_CATE_95	VS Battle
MENU_95	What is VS Battle?
MAIN_TITLE_95	What is VS Battle?
MAIN_TEXT_95	Rules for VS Battles are as follows:<br>■Set up a party of up to 5 units.<br>■You can set up unit placement on the map by tapping Unit Placement on the setup screen.<br>■Normal attacks won't trigger Combo Attacks.<br>■If the battle hasn't been concluded before the turn limit, the side with the most remaining HP will win the battle. If remaining HP is the same, the battle will be a draw.<br>■Every player has 10s time to act from start of turn, +10s when moving, and +10s when selecting an action.
MENU_CATE_96	VS Battle
MENU_96	What is Quick VS Battle?
MAIN_TITLE_96	What is Quick VS Battle?
MAIN_TEXT_96	<br><br><br><br><br><br><br><br><br><br><br><br><br><br><br><br><br><br><br><br><br><br><br>In a Quick VS Battle, you will be matched against a random user. It's also possible to set up a VS Battle by creating a room, and by sharing a room code or special URL.
MENU_CATE_97	VS Battle
MENU_97	What is VS Friend Battle?
MAIN_TITLE_97	What is VS Friend Battle?
MAIN_TEXT_97	In a VS Friend Battle, you can invite a friend to battle.<br>You can battle a friend by creating a room, and sharing a room code or special URL.<br>You can choose 1 of these methods to invite a friend:<br>■Recruit on LINE: Invite a friend by using LINE functionality.<br>■Copy URL: Invite a friend by tapping Copy to Clipboard, in order to send the URL.
MENU_CATE_98	Summon
MENU_98	Rare Summon
MAIN_TITLE_98	Rare Summon
MAIN_TEXT_98	Use Gems to obtain 3+★ units. Soul Shards are also obtainable. Once per day, you can draw one Rare Summon for a discounted Gem price. This is reset every day at midnight.
MENU_CATE_99	Summon
MENU_99	Normal Summon
MAIN_TITLE_99	Normal Summon
MAIN_TEXT_99	Use Zeni to obtain units, Soul Shards, equipment, etc. You can draw 5x per day for free. This is reset every day at midnight.
MENU_CATE_100	Shop
MENU_100	Shop Types
MAIN_TITLE_100	Shop Types
MAIN_TEXT_100	 
MENU_CATE_101	Shop
MENU_101	What is Zeni?
MAIN_TITLE_101	What is Zeni?
MAIN_TEXT_101	Zeni is the economic currency in the world of THE ALCHEMIST CODE. You can use Zeni to purchase items, train units and summon units, etc.
MENU_CATE_102	Shop
MENU_102	Sell
MAIN_TITLE_102	Sell
MAIN_TEXT_102	You obtain Zeni by selling items obtained through quests.
MENU_CATE_103	Shop
MENU_103	Gem Shop
MAIN_TITLE_103	Gem Shop
MAIN_TEXT_103	Gems are precious items which can be used for unit summoning, conversion to Zeni, AP replenishment, etc.<br>*Free Gems are used before Paid Gems.<br>*If you lack enough Free Gems for a certain transaction, Paid Gems will be used to reach the required total amount.
MENU_CATE_104	Shop
MENU_104	Soul Exchange Shop
MAIN_TITLE_104	Soul Exchange Shop
MAIN_TEXT_104	At the Soul Exchange Shop, you can use Soul Coins to purchase items and Soul Shards, etc. Soul Coins can be obtained by converting Soul Shards from Units who have reached Max Limit Break Lv. The lineup of the Soul Exchange Shop is random, though it's updated at specific times (9AM, 12AM, 6PM, 9PM, 12PM). You can also use Soul Coins to update the lineup yourself. The Soul Coin cost for updating the lineup increases each time, though every day at midnight, the cost is reset again to the initial cost.
MENU_CATE_105	Friends
MENU_105	Friends Function
MAIN_TITLE_105	Friends Function
MAIN_TEXT_105	The Friends Function allows you to become friends with other players. When becoming friends with someone, you can hire that player's mercenary for half of the price, compared to non-friends.
MENU_CATE_106	Friends
MENU_106	Friend List
MAIN_TITLE_106	Friend List
MAIN_TEXT_106	By viewing the Friend List, you can check which players are currently your friends.
MENU_CATE_107	Friends
MENU_107	Friend Notifications
MAIN_TITLE_107	Friend Notifications
MAIN_TEXT_107	Through Friend Notifications, you can see friend requests received from other players, and you can choose to approve or reject.
MENU_CATE_108	Friends
MENU_108	Search Friend
MAIN_TITLE_108	Search Friend
MAIN_TEXT_108	Through Search Friend, you can add friends by entering their Friend ID. You can also check your own Friend ID here to share to your friends.
MENU_CATE_109	System/Service/Other
MENU_109	Gift Function
MAIN_TITLE_109	Gift Function
MAIN_TEXT_109	Through the Gift Function, you can receive mail containing Login Bonuses or items.
MENU_CATE_110	System/Service/Other
MENU_110	Unclaimed
MAIN_TITLE_110	Unclaimed
MAIN_TEXT_110	In the Unclaimed tab of the Gift Function, you can check your unclaimed gifts.
MENU_CATE_111	System/Service/Other
MENU_111	History
MAIN_TITLE_111	History
MAIN_TEXT_111	In the Gift History tab of the Gift Function, you can check your history of claimed gifts.
MENU_CATE_112	System/Service/Other
MENU_112	User Code
MAIN_TITLE_112	User Code
MAIN_TEXT_112	Your User Code is important as the identification tag of your game data, and it is required when requesting support. You can check your User Code from the bottom of the title screen.
MENU_CATE_113	System/Service/Other
MENU_113	About Uninstalling the App
MAIN_TITLE_113	About Uninstalling the App
MAIN_TEXT_113	When uninstalling the app, all game data, including any paid items will be erased. Please bear in mind that if you haven't done a Data Transfer, your erased user data and purchased gems, etc., cannot be restored.
MENU_CATE_114	System/Service/Other
MENU_114	About Data Transfer
MAIN_TITLE_114	About Data Transfer
MAIN_TEXT_114	Through Data Transfer, even after switching to a new device, you can continue playing with your current game data. In order to transfer data, you need to register a gumi ID, and your gumi ID has to be linked to THE ALCHEMIST CODE.<br><br>▼For users who don't have a gumi ID<br>Go to Menu -> gumi ID, and tap Sign Up at the bottom of the screen.<br>Go to Title Screen Account -> Tap here if you don't have a gumi ID, and tap Sign Up at the bottom of the screen.<br>*After registering a gumi ID, please link it by tapping gumi ID Mission in the upper-left corner of the title screen.<br><br><br>[How to Transfer Data]<br>1)Tap Account in the bottom-right corner of the title screen. Please select Transfer through gumi ID from the selection screen.<br><br>2)Enter your registered gumi ID email and password, and tap confirm. Data Transfer is now finalized.<br><br>[Warning]<br>- Data transfer is not possible through backup systems such as iTunes and iCloud.<br>- When transferring between devices with different OS (iOS<->Android), please bear in mind that both Free and Paid Gems will be erased. Please bear in mind that you will not be compensated for any such erased Free / Paid Gems.
MENU_CATE_115	System/Service/Other
MENU_115	About Game Data Recovery
MAIN_TITLE_115	About Game Data Recovery
MAIN_TEXT_115	[About Game Data Recovery]<br>In case of game data loss due to troubles with your device, such as device loss or damage, etc., please send us a support enquiry. Please bear in mind that the process of this investigation may take time.
MENU_CATE_116	System/Service/Other
MENU_116	Recovery Cautionary Notes
MAIN_TITLE_116	Recovery Cautionary Notes
MAIN_TEXT_116	Please read the following cautionary notes in the event of game data loss.<br>- Actions involving impersonating other users, stating details of other players, etc., are prohibited.<br>- Recovery is only possible from the user's original device.<br>- If you cannot provide us with your player name, if your game data cannot be specified due to a lack of details, or due to other reasons where we judge it impossible to assist you, please bear in mind that we cannot help you with data recovery.<br>- You will not be eligible for events or campaigns launched during your data recovery process.<br>- Please bear in mind that you will not be compensated for any login bonuses that you may have missed during the data recovery process.
MENU_CATE_117	System/Service/Other
MENU_117	About Prohibited Conduct
MAIN_TITLE_117	About Prohibited Conduct
MAIN_TEXT_117	If it has been observed that a player has violated the terms of use of THE ALCHEMIST CODE, measures (such as account suspension) will be taken.<br>▼Examples of prohibited behavior<br>- Abusing software bugs in order to gain unintended game advantages, such as unfairly obtaining items<br>- Unjustly managing the application through usage of third party software<br>- Actions involving RMT (real money trading)<br>*We don't take any responsibility in the event of any losses suffered due to RMT.<br>- Promoting prohibited behavior<br>- Any actions that impede, of may impede the operation of this application<br>- Any other actions that violate the law or the terms of use<br><br>In order to maintain a pleasant and enjoyable game environment, we humbly ask you for your cooperation.<br>*We do not answer inquiries regarding prohibited behavior, whether measures have been taken after a report, or any particular questions about executed measures.<br>*We do not provide details about the reasons for account suspensions.
MENU_CATE_118	System/Service/Other
MENU_118	About Inquiries
MAIN_TITLE_118	About Inquiries
MAIN_TEXT_118	- Please bear in mind that our response to inquiries may be delayed, or that we may be unable to respond to some inquiries.<br>*We are closed on weekends and holidays, during which our support team is unavailable. Responses to inquiries will be sent on the next business day.<br>*The first workday after a holiday is busy for us, so please bear in mind that our response may be delayed.<br>- We do not respond to inquiries regarding in-game strategy, design or features.<br>- Please bear in mind that if you've reported any bugs, our response may be in the form of an announcement.<br>- Please bear in mind that as a principle, we do not respond to personal opinions or requests.<br>- It is prohibited to reproduce any response (partly or as a whole) sent by us to any particular users, or to use our responses for any secondary purpose, without prior consent.<br><br>If you haven't received any response within 24h, please check the following.<br>■Check settings related to your device's email spam-filter<br>- Whether your email account isn't set up to block emails from PC mail addresses for spoofing protection<br>- Whether your email account isn't blocking any emails containing URL's<br>- Whether you haven't set any exclusive sender domains or any blocked domains.<br>*Please set domain settings to accept emails from @fg-games.co.jp.<br>*When sending us an inquiry, you will receive an automatic response confirming our receipt. If you haven't received this, please check your email inbox settings.
MENU_CATE_NAME_1	World Lore
MENU_CATE_NAME_2	Quests
MENU_CATE_NAME_3	Units
MENU_CATE_NAME_4	Gear
MENU_CATE_NAME_5	Arena
MENU_CATE_NAME_6	Multiplay
MENU_CATE_NAME_7	VS Battle
MENU_CATE_NAME_8	Summon
MENU_CATE_NAME_9	Shop
MENU_CATE_NAME_10	Friends
MENU_CATE_NAME_11	System/Service/Other
