SRPG_ChatChannelMasterParam_1_NAME	New Players' Discussion
SRPG_ChatChannelMasterParam_2_NAME	New Players' Questions
SRPG_ChatChannelMasterParam_3_NAME	Alchemia Port
SRPG_ChatChannelMasterParam_4_NAME	New Members Welcome
SRPG_ChatChannelMasterParam_5_NAME	Character Discussion
SRPG_ChatChannelMasterParam_6_NAME	Character Training
SRPG_ChatChannelMasterParam_7_NAME	Story Quest
SRPG_ChatChannelMasterParam_8_NAME	Event Quest
SRPG_ChatChannelMasterParam_9_NAME	Multiplay
SRPG_ChatChannelMasterParam_10_NAME	Collab Event
SRPG_ChatChannelMasterParam_11_NAME	Sacred Stone Memories
SRPG_ChatChannelMasterParam_12_NAME	Mystic Tower Veda
SRPG_ChatChannelMasterParam_13_NAME	Gear
SRPG_ChatChannelMasterParam_14_NAME	Shop
SRPG_ChatChannelMasterParam_15_NAME	Arena
SRPG_ChatChannelMasterParam_16_NAME	Battle
SRPG_ChatChannelMasterParam_17_NAME	Discussion Room 01
SRPG_ChatChannelMasterParam_18_NAME	Discussion Room 02
SRPG_ChatChannelMasterParam_19_NAME	Discussion Room 03
SRPG_ChatChannelMasterParam_20_NAME	Discussion Room 04
