SK_CARD_002_CONCEPT_TXT	全英`l
SK_CS_CARD_003_CONCEPT_TXT	卡rb浜罂砂l
SK_SNI_LEG_SNIPE_CONCEPT_TXT	拉b浜罂砂l
SK_SNI_HEAD_SNIPE_CONCEPT_TXT	拉b浜罂砂l
SK_SNI_PIERCING_SNIPE_CONCEPT_TXT	拉b浜罂砂l
SK_SNI_A_MATERIAL_BURST_CONCEPT_TXT	拉b浜罂砂l
SK_CANON_CARD_001_SKILL1_CONCEPT_TXT	卡rb浜罂砂l
SK_CANON_CARD_001_SKILL2_CONCEPT_TXT	卡rb浜罂砂l
SK_KADA_WEPON_CONCEPT_TXT	卡_Z巴b浜罂砂l
SK_HIEN_CARD_001_CONCEPT_TXT	出身地榘脖壤的英`b浜罂砂l
SK_ARMS_SWO_CLOE_CONCEPT_TXT	出身地榘脖壤的英`b浜罂砂l
SK_ARM_STRENGTH_CONCEPT_TXT	全英`l
SK_DGN_SKY_HIGH_CONCEPT_TXT	全英`l
SK_MAD_SUPPORT_2_CONCEPT_TXT	全英`l
SK_CS_CARD_004_CONCEPT_TXT	全英`l
SK_PSI_SUPPORT_2_CONCEPT_TXT	全英`l
SK_AF_ACCS_BRACELET_02_WA_CONCEPT_TXT	全英`l
SK_CS_CARD_005_CONCEPT_TXT	女性英`b浜罂砂l
SK_CS_CARD_006_CONCEPT_TXT	男性英`b浜罂砂l
SK_CS_CARD_007_CONCEPT_TXT	暗傩杂㈧`b浜罂砂l
SK_CS_CARD_008_CONCEPT_TXT	暗黑T士、上暗Tb浜罂砂l
SK_CS_CARD_009_CONCEPT_TXT	出身地榘脖壤的英`b浜罂砂l
SK_CS_CARD_010_CONCEPT_TXT	p炎T士F
SK_CARD_SEIREINOKAGO_CONCEPT_TXT	}T士或魔道士的拉或卡r或梅莉b浜罂砂l
SK_CARD_OVER_SOUL_CONCEPT_TXT	鹗炕蚰У朗康睦或卡r或梅莉b浜罂砂l
SK_CARD_SUPPORT_2_CONCEPT_TXT	忍者或武}的拉或卡r或梅莉b浜罂砂l
SK_AF_ACCS_SQ_BELT_01_5_CONCEPT_TXT	}T士或魔道士的拉或卡r或梅莉b浜罂砂l
SK_AF_ARMS_TEM_02_5_CONCEPT_TXT	鹗炕蚰У朗康睦或卡r或梅莉b浜罂砂l
SK_ARMO_FUNDOSHI_CONCEPT_TXT	忍者或武}的拉或卡r或梅莉b浜罂砂l
	
SK_GS1_ENVYRIA_VETTEL_01_CONCEPT_TXT	p炎T士Fb浜PT鹊木p炎T士F能力UP<br>p炎T士F英`：<br>S特<br>克_伊<br>S克塔<br>杰拉德<br>娜塔莉<br>__尼央<br>※世界渎ver的克_伊不在其列
SK_GS1_ENVYRIA_CLOE_01_CONCEPT_TXT	p炎T士Fb浜PT鹊木p炎T士F能力UP<br>p炎T士F英`：<br>S特<br>克_伊<br>S克塔<br>杰拉德<br>娜塔莉<br>__尼央<br>※世界渎ver的克_伊不在其列
SK_GS1_ENVYRIA_FAIRLILY_01_CONCEPT_TXT	安比利出身的英`b浜PT鹊陌脖壤英`能力UP
SK_GS1_ENVYRIA_SHAYNA_01_CONCEPT_TXT	安比利出身的英`b浜PT鹊陌脖壤英`能力UP
SK_GS1_ENVYRIA_LGDSAG_01_CONCEPT_TXT	安比利出身的英`b浜PT鹊陌脖壤英`能力UP
SK_GS1_ENVYRIA_ELIZABETH_01_CONCEPT_TXT	安比利出身的英`b浜PT鹊陌脖壤英`能力UP
SK_GS1_ENVYRIA_MONZOTM_01_CONCEPT_TXT	}教T士Fb浜PT鹊穆}教T士F能力UP<br>}教T士F英`：<br>卡r<br>卡_Z巴<br>神<br>爝_恩修坦<br>_<br>蒙梢<br>扎因<br>W提<br>趵斯<br>巴西尼
SK_GS1_ENVYRIA_MARGARET_01_CONCEPT_TXT	安比利出身的英`b浜PT鹊陌脖壤英`能力UP
SK_GS1_ENVYRIA_DARTAGNAN_01_CONCEPT_TXT	p炎T士Fb浜PT鹊木p炎T士F能力UP<br>p炎T士F英`：<br>S特<br>克_伊<br>S克塔<br>杰拉德<br>娜塔莉<br>__尼央<br>※世界渎ver的克_伊不在其列
SK_WA_01_ENVYRIA_VETTEL_01_CONCEPT_TXT	安比利出身英`或者莉・趼宀洛斯「大^y者」可以使用
SK_WA_02_ENVYRIA_VETTEL_01_CONCEPT_TXT	全英`可使用
SK_WA_01_ENVYRIA_CLOE_01_CONCEPT_TXT	安比利出身英`或者莉・趼宀洛斯「大^y者」可以使用
SK_WA_02_ENVYRIA_CLOE_01_CONCEPT_TXT	全英`可使用
SK_WA_01_SLOTH_FIONA_01_CONCEPT_TXT	斯洛斯修坦出身英`或者莉・趼宀洛斯「大^y者」可以使用
SK_GS1_SLOTH_FIONA_01_CONCEPT_TXT	斯洛斯修坦出身的英`b浜PT鹊乃孤逅剐尢褂㈧`能力UP
SK_GS1_DISGAEA_01_CONCEPT_TXT	魔界鹩佑㈧`b浜PT鹊哪Ы鹩佑㈧`能力UP
SK_GS2_ENVYRIA_VETTEL_01_CONCEPT_TXT	特定的英`b浜PT忍囟ㄓ㈧`的能力UP<br>ο笥㈧`：<br>S特<br>杰拉德<br>娜塔莉
SK_GS2_ENVYRIA_CLOE_01_CONCEPT_TXT	特定的英`b浜PT忍囟ㄓ㈧`的能力UP<br>ο笥㈧`：<br>克_伊<br>※世界渎ver的克_伊不在其列
SK_GS2_ENVYRIA_FAIRLILY_01_CONCEPT_TXT	特定的英`b浜PT忍囟ㄓ㈧`的能力UP<br>ο笥㈧`：<br>菲莉莉<br>克莉<br>艾
SK_GS2_ENVYRIA_SHAYNA_01_CONCEPT_TXT	特定的英`b浜PT忍囟ㄓ㈧`的能力UP<br>ο笥㈧`：<br>雪娜<br>鹿
SK_GS2_ENVYRIA_LGDSAG_01_CONCEPT_TXT	特定的英`b浜PT忍囟ㄓ㈧`的能力UP<br>ο笥㈧`：<br>洛基<br>迪W斯
SK_GS2_ENVYRIA_ELIZABETH_01_CONCEPT_TXT	特定的英`b浜PT忍囟ㄓ㈧`的能力UP<br>ο笥㈧`：<br>伊莎白<br>戴<br>安娜
SK_GS2_ENVYRIA_MONZOTM_01_CONCEPT_TXT	特定的英`b浜PT忍囟ㄓ㈧`的能力UP<br>ο笥㈧`：<br>蒙梢<br>W提
SK_GS2_ENVYRIA_MARGARET_01_CONCEPT_TXT	特定的英`b浜PT忍囟ㄓ㈧`的能力UP<br>ο笥㈧`：<br>格特<br>伊莎白
SK_GS2_ENVYRIA_DARTAGNAN_01_CONCEPT_TXT	特定的英`b浜PT忍囟ㄓ㈧`的能力UP<br>ο笥㈧`：<br>__尼央
SK_GS1_LETTER_01_CONCEPT_TXT	b浜PT热英`的能力UP
SK_GS1_LETTER_02_CONCEPT_TXT	b浜PT热英`的能力UP
SK_GS2_SLOTH_FIONA_01_CONCEPT_TXT	特定的英`b浜PT忍囟ㄓ㈧`的能力UP<br>ο笥㈧`：<br>菲W娜<br>艾德加<br>洛斯
SK_GS2_ENVYRIA_RUNBELL_01_CONCEPT_TXT	安比利出身的英`b浜PT鹊陌脖壤英`能力UP
SK_GS1_ENVYRIA_RUNBELL_01_CONCEPT_TXT	特定的英`b浜PT忍囟ㄓ㈧`的能力UP<br>ο笥㈧`：<br>拉
SK_GS1_ENVYRIA_DECEL_01_CONCEPT_TXT	特定的英`b浜PT忍囟ㄓ㈧`的能力UP<br>ο笥㈧`：<br>戴
SK_GS1_ENVYRIA_ALFRED_01_CONCEPT_TXT	特定的英`b浜PT忍囟ㄓ㈧`的能力UP<br>ο笥㈧`：<br>阿弗雷德<br>雪娜
SK_GS1_ENVYRIA_PRISCILA_01_CONCEPT_TXT	特定的英`b浜PT忍囟ㄓ㈧`的能力UP<br>ο笥㈧`：<br>普希拉<br>拉米<br>特砩
SK_GS1_ENVYRIA_ELAINE_01_CONCEPT_TXT	特定的英`b浜PT忍囟ㄓ㈧`的能力UP<br>ο笥㈧`：<br>艾
SK_GS1_ENVYRIA_DILGA_01_CONCEPT_TXT	特定的英`b浜PT忍囟ㄓ㈧`的能力UP<br>ο笥㈧`：<br>迪加
SK_GS1_ENVYRIA_AGATHA_01_CONCEPT_TXT	特定的英`b浜PT忍囟ㄓ㈧`的能力UP<br>ο笥㈧`：<br>洛基<br>迪W斯<br>吉克
SK_GS2_ENVYRIA_AYLLU_01_CONCEPT_TXT	斯特布克出身的英`b浜PT鹊聂斯特布克英`能力UP
SK_GS1_ENVYRIA_AYLLU_01_CONCEPT_TXT	特定的英`b浜PT忍囟ㄓ㈧`的能力UP<br>ο笥㈧`：<br>艾琉
SK_GS1_ENVYRIA_ROTEN_01_CONCEPT_TXT	安比利出身的英`b浜PT鹊陌脖壤英`能力UP
SK_GS1_ENVYRIA_RUNBELL_01_CONCEPT_TXT	特定的英`b浜PT忍囟ㄓ㈧`的能力UP<br>ο笥㈧`：<br>拉
SK_GS1_ENVYRIA_FOUNTAIN_01_CONCEPT_TXT	安比利出身的英`b浜PT鹊陌脖壤英`能力UP
SK_GS1_ENVYRIA_ALAIA_01_CONCEPT_TXT	特定的英`b浜PT忍囟ㄓ㈧`的能力UP<br>ο笥㈧`：<br>安拉伊
SK_GS1_ENVYRIA_FOUNTAIN_01_CONCEPT_TXT	安比利出身的英`b浜PT鹊陌脖壤英`能力UP
SK_GS1_ENVYRIA_LUCRETIA_01_CONCEPT_TXT	特定的英`b浜PT忍囟ㄓ㈧`的能力UP<br>ο笥㈧`：<br>R克蕾蒂<br>ゲw因
SK_GS1_ENVYRIA_VICTOR_01_CONCEPT_TXT	p炎T士Fb浜PT鹊木p炎T士F能力UP<br>p炎T士F英`：<br>S特<br>克_伊<br>S克塔<br>杰拉德<br>娜塔莉<br>__尼央<br>※世界渎ver的克_伊不在其列
SK_GS2_ENVYRIA_VICTOR_01_CONCEPT_TXT	特定的英`b浜PT忍囟ㄓ㈧`的能力UP<br>ο笥㈧`：<br>S特<br>克_伊<br>S克塔<br>娜塔莉<br>妮娜
SK_WA_01_ENVYRIA_VICTOR_01_CONCEPT_TXT	全英`可使用
SK_WA_01_WRATHTRIZ_ZAHAR_01_CONCEPT_TXT	全英`可使用
SK_GS1_WRATHTRIZ_ZAHAR_01_CONCEPT_TXT	影之梅_b浜PT鹊挠爸梅_的能力UP<br>影之梅_英`：<br>扎哈<br>z碧卡<br>蕾迪<br>西<br>啥<br>梅雅<br>※Fatever的扎哈不在其列
SK_GS2_WRATHTRIZ_ZAHAR_01_CONCEPT_TXT	特定的英`b浜PT忍囟ㄓ㈧`的能力UP<br>ο笥㈧`：<br>扎哈<br>蕾迪
SK_WA_01_WRATHTRIZ_SPICA_01_CONCEPT_TXT	拉斯特里斯出身英`或者趼宀洛斯「大的^y者」可以使用
SK_WA_02_WRATHTRIZ_SPICA_01_CONCEPT_TXT	全英`可使用
SK_GS1_WRATHTRIZ_SPICA_01_CONCEPT_TXT	影之梅_b浜PT鹊挠爸梅_的能力UP<br>影之梅_英`：<br>扎哈<br>z碧卡<br>蕾迪<br>西<br>啥<br>梅雅<br>※Fatever的扎哈不在其列
SK_GS2_WRATHTRIZ_SPICA_01_CONCEPT_TXT	特定的英`b浜PT忍囟ㄓ㈧`的能力UP<br>ο笥㈧`：<br>z碧卡<br>西
SK_GS1_WRATHTRIZ_GLANZ_01_CONCEPT_TXT	拉斯特里斯出身的英`b浜PT鹊睦斯特里斯英`能力UP
SK_GS2_WRATHTRIZ_GLANZ_01_CONCEPT_TXT	特定的英`b浜PT忍囟ㄓ㈧`的能力UP<br>ο笥㈧`：<br>格m<br>安娜塔西
SK_GS1_WRATHTRIZ_LAMIA_01_CONCEPT_TXT	拉斯特里斯出身的英`b浜PT鹊睦斯特里斯英`能力UP
SK_GS2_WRATHTRIZ_LAMIA_01_CONCEPT_TXT	特定的英`b浜PT忍囟ㄓ㈧`的能力UP<br>ο笥㈧`：<br>拉米<br>特砩<br>※Fatever的拉米不在其列
SK_GS1_WRATHTRIZ_ROSA_01_CONCEPT_TXT	拉斯特里斯出身的英`b浜PT鹊睦斯特里斯英`能力UP
SK_GS2_WRATHTRIZ_ROSA_01_CONCEPT_TXT	特定的英`b浜PT忍囟ㄓ㈧`的能力UP<br>ο笥㈧`：<br>}莎<br>※魔界鹩ver的}莎不在其列
SK_GS1_WRATHTRIZ_MAGNUS_01_CONCEPT_TXT	特定的英`b浜PT忍囟ㄓ㈧`的能力UP<br>ο笥㈧`：<br>R格努斯<br>史特莉I<br>凵
SK_GS1_WRATHTRIZ_SABALETA_01_CONCEPT_TXT	特定的英`b浜PT忍囟ㄓ㈧`的能力UP<br>ο笥㈧`：<br>_巴雷<br>瓦妮琪斯
